infra-estrutura	infrastructure
contudo	however	yet	nevertheless
ponderar	ponder
Aéreo	aerial	air
proporção	proportion
verde	green
repórter	reporter
junto	together	along	near	next to	close	united	joined
direto	direct	straight
represália	reprisal	revenge	retaliation
conseqüência	consequence
esgotar	drain	use up
diligência	diligence	investigation
verificar	verify	examine	check
componente	component	competent
crítico	critic
contribuinte	contributor
responsabilizar	make responsible	consider responsible
gasolina	gas	gasoline	petrol
segurar	insure	make secure	make safe	hold	grasp
maquiar	take fraudulently
anúncio	add	advertisement	announcement	placard	notice
descanso	rest	ease	relaxation
disposição	disposition	disposal	aptitude	inclination	tendency	temper	mood	nature
burocrático	bureaucratic
contrapartida	counterpart	opposite
instrumento	instrument
abdicar	abdicate	renounce
não	no	not
morar	live	inhabit
autoria	authorship
moral	morality	moral	ethical
A	the
década	decade
inundar	inundate	flood
O	the
estimado	esteemed	appreciated
perfeito	perfect
resumir	summarize	abridge
infantaria	infantry
deslocar	dislocate
seguiu	follow
fluxo	flood	ebb	flow	flux
seguir	follow
clicar	click
porta	door
g	the letter g	symbol of gram
e	and
esse	that
a	the
medida	measure	measurement
doméstico	domestic
caótico	chaotic
acessar	access
comprometer	commit	promise	oblige
o	the
recado	message	word
m	the letter m	symbol of meter
arquipélago	archipelago
transação	transaction	business	deal
respeitar	respect	honor	venerate
h	hour symbol
diocese	diocese
porto	port	harbor	haven
esportivo	sportive
vaga	vacancy	opening	space
r	the letter r
resgatar	rescue	ransom	redeem
mutação	mutation	change
Fez	did
zona	zone
extratos	extract	statement
fuga	flight	escape	retreat	subterfuge
língua	language	tongue
cabo	cable
avaliação	evaluation	estimation	assessment
coluna	column	post	spine
trimestre	trimester	quarter
roubar	steal	rob
interdição	interdiction
demonstrar	demonstrate	show
turista	tourist
pretender	intend	mean
administrar	administer	manage	direct	conduct
roubadas	stolen	robbed
ladrão	thief	robber
ª	the
cronograma	chronogram
fechar	close
juntar	join	merge
quesito	enquiry	query	question	subject or issue
colunista	columnist
Treze	thirteen
massacre	massacre
º	the
Aeroporto	airport
cassação	abrogation	act of cancelling or annulling	repeal
largura	breadth	width	broadness	wideness
reunião	meeting	reunion
meteorologista	meteorologist
dificuldade	difficulty
precaução	precaution
É	and
recair	fall back	relapse	suffer setback
documentação	documentation
sobrar	overabound	be in excess	exceed
especialista	specialist
pequeno	little	small
ajuizamento	judgment
publicar	publish
categoria	category
opinar	judge	opine	think
certamente	surely	undoubtedly	unquestionably
grau	degree	grade
meia	sock	stocking	number six
somente	only	just	merely	solely
concentrar	concentrate
desligar	turn off	disconnect	shutdown
vôos	flight
meio	means	middle
noticiário	news section of newspaper	news	news service
caco	potsherd	shard
profissional	professional
canalha	scoundrel	villain
é	it is
mensagem	message
magnitude	magnitude
estourar	burst	split	shatter
à	to the
medalha	medal
queixa	complaint
público	public
vaca	cow
encaminhar	conduct	lead	forward
invadir	invade
organização	organization	group
pequena	little	small
agressivo	aggressive
cumprimentar	greet	salute	compliment
representação	representation
acusação	accusation
localidade	locality
juntos	united	joined
junção	junction
longe	far	far off	distant	far away
promotor	promoter
disponível	available
reabertura	reopening
seqüência	sequence
frear	brake
velório	wake
governador	governor	ruler
longo	long	lengthy
enviado	envoy
tramitação	normal course through legal channels
bloqueada	blocked
aprimorar	improve	perfect
pedido	petition	request	solicitation
disparar	fire	discharge	shoot
tentavam	try	attempt	tempt
fiscalização	control	supervision	inspection
possibilidade	possibility
ética	ethics
envio	shipment
branco	white
temporada	period	season	period of stay
superação	act or effect of overcoming	surmounting
prejudicado	damaged
efetivos	effective
iminente	imminent	impending
estômago	stomach
todo	all	entire	whole
inadequado	inadequate
reagir	react	respond	resist
colega	colleague	mate	peer
profundo	deep
reservista	reservist	member of the military reserves
demais	too much	excessive
pressão	pressure
simples	simple	plain	evident	clear
opinião	opinion
indignação	indignation
travado	connected	joined	linked
eventual	occasional	fortuitous
muro	wall
brincar	play	toy	entertain	amuse	joke	fun	fool
trabalhar	work	strive	perform	struggle
lutar	fight	struggle
decolar	take off
mandato	mandate	order	trust
sensação	sensation
adversário	adversary
teste	test	experiment	qui z
desvalorização	devaluation
companhias	company	companion
intelectual	intellectual
sistema	system
comandante	commander
regularizar	regularize	rectify	make uniform
habilidosos	skilful	skilled	handy	dexterous
quebrar	break	crack	fracture
subúrbio	suburb	outskirts	environ
tentação	temptation
dupla	duo
quadrado	square
quadro	board	square	picture frame
virar	turn
estocar	stock
rebelde	rebel	insurgent	deserter	rebelling	deserting
gestual	gestural
obstruir	obstruct	impede
conselho	advice	warning	council	board
mesa	table
decorrente	deriving	resulting from
ciclo	cycle
mero	jewfish	mere	simple
dita	aforementioned
vaia	hoot	hissing	derision
assim	thus	therefore	thereby	so	in this manner
vazamentos	leak	leakage
jogo	game	match	bet	gamble	play
preferir	prefer
seleção	selection	act of selecting	team of chosen players
bagagem	baggage
trégua	armistice	truce	pause
critério	criterion
ídolo	idol
vitórias	victory
vale	valley	vale	dale
código	code
danificados	damaged
sobrevivência	survival
meteorológico	meteorological
cachorro	dog
diálogo	dialogue
alegar	allege
rio	river
realmente	really	actually	truly
esperança	hope	expectation
arrancar	pull or tear away from	jerk away
dormitório	dormitory
justiça	justice
capitão	captain
ginasta	gymnast
prático	practical	functional
duplo	double
calor	heat	warmth
prever	foresee	calculate
cidade	city	town
aeroporto	airport
calou	shut up	hush up	quieten	silence
quadra	court	quartet
estádio	stadium
recomendar	recommend	commend	praise
reconhecer	recognize	acknowledge
cardíaco	cardiac
admirável	admirable
avenidas	avenue
amigo	friend
mercado	market	marketplace	commerce
documentos	document
metropolitano	metropolitan
ritmo	rhythm	cadence	beat
músico	musician	singer	player	composer
advogado	lawyer	attorney
gástrico	gastric
samba	samba
comandara	command
prefeito	mayor
realista	realist
plenário	plenary assembly
estável	stable
acontecido	occurrence	happening
voltaram	come back	return
sobretudo	overcoat	coat
perto	near	close
querer	want	wish
requerer	request	demand	entail	require
insignificante	insignificant
confundir	confuse	perplex
criação	creation	raising	upbringing
favor	favor
preso	prisoner	convict	captive
espalhar	spread
objetivo	objective	aim	goal
ajudar	help
durante	during
universitário	universitarian
paciência	patience
meta	aim	goal	target	wicket
atualmente	currently	presently	at present
intensificar	intensify
Senado	senate	upper house of legislature	senate house
vôlei	volley
entender	understand
vivo	alive	living
preto	black
pico	peak	apex
desabrigar	unshelter	leave without shelter
sentido	sense	meaning
documento	document
exorbitantes	exorbitant
dinheiro	money
liquidação	sale	clearance
etnia	ethnic group
sigla	abbreviation	initials	monogram
revisão	revision	review	proofreading	reform
provisão	supply	provision
irá	will go
órgão	organ
laudo	appraisal	appraisement	report	expert opinion
preservação	preservation
vara	stick	rod	switch	staff	pole	stave	cane
cara	face	dude	guy	man
hipótese	hypothesis
praticar	practice	exercise
destacar	feature	highlight	emphasize	detach
sobrepor	put on or upon	superpose
corrupção	corruption
errado	wrong	mistaken
processamento	processing
atômico	atomic
míssil	missile
reivindicar	claim formally	reclaim	recover	regain
casa	house
delegacia	police station
barato	cheap
preliminar	preliminary
monitorar	monitor
caso	case	instance	affair	if
extração	extraction
violento	violent
detonação	detonation
rua	street
ganhador	winner	conqueror
reversão	reversion	reversal
visa	vision
indignado	indignant
baixo	low	short	down	bass
decorrência	consequence
votado	voted	approved
atentado	attempt	attack	assault
abusos	abuse
ginástico	gymnastic	gymnastical
necessário	necessary
acaso	chance	luck
nomear	name	call
jeito	manner	way	aptitude	aptness
suposto	supposition	presumption
escolher	choose
embalar	wrap
início	beginning	opening
rebelião	rebellion	mutiny	insurrection
indiciar	indict	accuse
suposta	supposition	presumption
passageiro	passenger	traveller
gesticular	gesticulate	make gestures
acreditar	believe
admitir	admit
recibo	receipt
bater	beat	hit	strike	knock	spank
estrela	star
raiva	rage	fury	anger
ocupante	occupier	occupant	occupying
captar	capture	catch	collect
comunicação	communication
deputado	deputy	representative
participar	participate	communicate
acidentar	cause an accident
flutuante	fluctuating
objeção	objection	opposition
acidental	accidental	unexpected
tremer	tremble	shiver	quake	shake
estender-se	extend	stretch	dilate	expand	widen	be enlarged
autenticidade	authenticity
desejar	desire	wish
pancada	blow	shock	knock	collision
tratar	treat	deal with
cabeça	head
conflituoso	conflictive	conflicting
autor	author
ambos	both
cheio	full	filled up	crowded	packed
Copa	cup	competition	top	crown	dining room
danificadas	damaged
escalar	scale	climb by	escalade
jogador	player	gambler
reparo	repair	mending	restoration
multinacional	multinational
soma	sum	total	soma
cultura	culture
tripulação	crew	personnel
especialidade	speciality
filmar	film	shoot
supostas	supposition	presumption
Ele	he
mandar	order	command
artístico	artistic
prol	in favor of
eliminou	eliminate
construir	construct
singelo	plain	simple	sincere	artless
presidencial	presidential
emoção	emotion
apelido	nickname	nick
peça	piece	play
chocante	shocking	scandalous
cocaína	cocaine
procurador	procurator	attorney
telefone	telephone
desmatamento	deforestation
comemorar	celebrate	commemorate
vítima	victim
comportamento	behavior
página	page
disparou	fire	discharge	shoot
discussão	discussion	debate	argument	quarrel
contrato	contract	covenant	indenture
caiu	fell
chega	enough	censure	reprimand	rebuke
levantamento	lifting	raising	weightlifting	survey
andar	walk	ride
leão	lion
posto	post	place	position
reforçar	reinforce	strengthen
apoio	support	base	basis	foundation
cair	fall	drop	decline	decay
viciadas	addict	fiend
calar	shut up	hush up	quieten	silence
assinante	subscriber	signatory
combater	flight	combat
apontar	point	appoint	sharpen
pesar	sadness	weigh
bonito	beautiful	handsome
medir	measure
chefe	chief	boss	head	chef
comparecer	attend	show up	report
denunciados	defendant
prevenção	prevention
morreram	die
torcedor	twister	athletic fan	twisting	winding
turismo	tourism
enterro	burial
noite	night
soer	accustom	habituate	be accustomed	be habituated
centena	a hundred	group of a hundred
corpo	body
econômico	thrifty	economic
vacinação	vaccination	inoculation
falência	bankruptcy
característico	characteristic
entrevista	interview
traficante	trafficker	trader	dealer	swindler
episódio	episode
sobrevivente	surviving
aumento	increase	rise	raise	enlarging	enlargement
gesto	gesture	gesticulation
folgar	rest	repose	be at ease
impor	impose	saddle
desligado	switched off
posse	ownership	possession
sinalizar	signalize
pior	worse	worst
imprevidência	improvidence	imprudence
erro	mistake	error
ativistas	activist
obstáculo	obstacle	hindrance	blockage	obstruction
agir	act	take action
apresentado	presented
eleitoral	electoral
madrugada	dawning	daybreak	late night
harmonia	harmony
agravamento	aggravation	worsening
rivalidade	rivalry	opposition
continental	continental
humanidade	humanity
assassino	assassin	murderer
limite	limit	border
fantasmas	phantasm	phantom	ghost	spirit
instância	instance
romper	break	rupture	break through
retomar	take back	recover	retrieve
caído	fallen	decayed	decrepit
disparo	shot
perguntar	ask	question	interrogate	query
perda	loss
estufar	stew	heat	put in greenhouse
fórmula	formula	prescription
almoço	lunch
pobreza	poverty
estudo	study	act of studying	learning
alteração	alteration	change
impecável	impeccable
ilhar	isolate	insulate	confine
envolver	involve	surround	enclose
comerciante	merchant	dealer	trader
lentidão	slowness
especificar	specify
escola	school
expresso	express train	express	clear
canal	canal	channel	riverbed
notoriedade	notoriety
questionário	questionnaire
questão	question	issue	matter	controversy	debate	dispute
simpatia	liking	affection	compatibility
sim	yes
especulação	speculation
zoneamento	zoning
classificação	classification
bloquear	block
manter	maintain	keep
parafuso	screw
vídeo	video
fechamento	shutting or locking up	closure
averiguar	inquire	investigate
gás	gas	vapor	fume
titular	titular	noble person	entitle	give a title	call
chamado	called	summoned	calling	convocation
noticiar	inform	report
torneio	turning	refinement of form	tourney	joust
caráter	character
confirmar	confirm	affirm	approve	sustain	homologate	sanction
executivo	executive
salarial	of or referring to salaries or wages
ligado	connected	tied together
permanecer	remain
antiga	old	antique
paróquia	parish	city district
resíduo	residue
amarrado	tied up
meia-noite	midnight
regra	norm	standard	rule	regulation	law	decree
liberação	liberation	release
ser	be	being
rasteiro	creeping	crawling	low	humble	modest
féria	workday	wages	rest	repose
aviação	aviation
aéreos	aerial	air
suplente	substitute	proxy
antigo	old	ancient	antique
vida	life
comando	act of command	command	order
traiçoeiro	treacherous	perfidious	traitorous
legitimidade	legitimacy
acompanhamento	escort	accompaniment	trimming	side order	side dish
matéria	matter	subject
frango	chicken
delinqüente	delinquent
bairro	neighborhood	borough	district
tijolo	brick
salto	leap	hop	jump	shoe heel	waterfall	cataract
computador	computer
São	sound	healthy	saint	are
transferência	transference	transferral	removal	change
influenciar	influence
denúncia	denunciation
custar	cost
candidatura	candidacy
agitado	agitated	excited
finalizar	finalize
programa	program
levar	take	carry	lead	go
serrar	saw
recorrente	recurrent	happening again
preocupado	worried	concerned	preoccupied
reservatório	reservoir	deposit	store	receiver
urbano	urban
constitucional	constitutional
som	sound	tonality	manner
avanço	advance	advancement	headway
cervejaria	brewery
terra	earth	land
Igreja	church
avais	surety	guaranty
inversão	inversion
fundo	bottom	deep	back
pediram	ask	beg
danificar	damaged
deputar	depute	delegate
pendular	pendular	swinging
coragem	courage	bravery
cartão	cardboard	card	calling card
recorde	record	feat	accomplishment
mestre	master
instruir	instruct
calcular	calculate
salientar	point	emphasize	stress
feio	ugly
polar	polar
rachadura	crack	fissure	cleaving	splitting
escanteio	corner
efusão	effusion
consciência	conscience	consciousness	perception	awareness
Império	empire	imperium
equipe	team
faturar	invoice	bill	charge
campo	field	area	countryside	interior
líder	leader
craque	expert
reformar	reform	remodel
período	period
investigar	investigate
publicação	publication
causa	cause	reason	motive	lawsuit	case	process
funcionária	employee	clerk	official
experiência	experience
perna	leg
tigre	tiger
funcionário	employee	clerk	official
Todos	everybody	everyone
bloqueio	block
ligar	start	call	link	tie	bind	care
grupo	group
transmissão	transmission
polícia	police
paroquiano	parochial	parishioner
três	three
abaixar	lower	turn down
futebol	football	soccer
semifinal	semifinal
relativo	relative
secretário	secretary
espacial	spatial
agência	agency
rede	net	network
preocupar	worry
combate	combat
fabricar	fabricate	manufacture
autorização	authorization
líquido	liquid
permitir	allow	permit
específico	specific
sugerir	suggest
eliminar	eliminate
significativo	significative	significant
real	real	royal
propina	tip	gratuity
precipitado	hurried	hasty
resultado	result	consequence	effect
previsão	forecast	prediction
homicídio	homicide
alusão	allusion
tramitar	follow legal channels
repartição	partition	department	branch	section
ainda	still	yet
assinatura	signature
união	union
nevoeiro	mist	fog
lotação	allotment	capacity
transformar	transform	alter	change
dificultar	raise difficulties	hamper	embarrass
empenho	endeavor	exertion
liberdade	liberty
rumo	bearing	route	course	direction
favorito	favorite	pet	fondling
astrônomo	astronomer
rendimento	revenue	return	profit
pagamento	payment	disbursement
consultoria	consultancy	consultant
precisar	need	necessitate	require	demand
delegar	delegate	authorize
democracia	democracy
favorita	favorite	pet	fondling
intervalo	lapse	recess	break	interval
parlamentar	parliamentarian	parliamentary	negotiate a truce
crime	crime
próprio	own	proper
potência	potency	power
freqüente	frequent	often
maravilhoso	wonderful
gordura	fat
continuidade	continuity
tensão	tension	strain	stress
espalhado	scattered
retórico	rhetor	rhetorician	orator
estreante	debutant	beginner	novice
congestiva	congestive
figura	figure	picture
eclodir	emerge
família	family
civil	civil	civilian
complexo	complex
trecho	period	interval	stretch	distance	section
estação	station	season
oito	eight
reportagem	newspaper report	class of reporters generally
balançou	balance	sway
ministério	ministry
religar	retie	bind again	rejoin
conforto	comfort
passar	pass	exceed	surpass
tirania	tyranny	despotism
segredo	secret	confidential
porta-voz	spokesperson
repressão	repression	suppression
artigo	article	composition
comício	meeting	rally	demonstration
comoção	commotion	disturbance	riot
pedalar	pedal
fábrica	plant	factory
jogado	half dead	abandoned
formação	formation	education
percorrido	go through
binário	binary
cerimônia	ceremony	rite
completo	complete	entire
jogada	scheme	plot
sobreviventes	surviving
implantar	implant
greve	strike
seguinte	next	following
bomba	bomb	pipe
fumaça	smoke
relato	report	account	narration
concorrer	compete	rival
sul	south
pontes	bridge
administração	administration
panorama	panorama
vinculado	entailed	bound	linked
severo	severe	rigid
configurar	configure
ofício	craft	trade	art	workmanship
vôo	flight
descarrilar	derail
peito	chest	breast
prevaricação	prevarication
crucial	crucial
sustentação	sustenance	maintenance
requerimento	formal petition	application
simplesmente	simply
sugestão	suggestion
emparelhar	pair up
saldo	balance	rest	outcome
informante	informer	informant
refugiado	refugee	displaced person	fugitive
Depois	after	following
transbordamento	overflow	inundation
associação	association	society
participação	participation
democrata	democrat
bolso	pocket
renal	renal	relating to the kidneys
fiscalizar	subject to fiscal control	examine	control	check
confiança	confidence	trust	faith	belief
criminal	criminal
convocar	summon	convoke
falso	false	untrue
apresentar	present	introduce
lanterna	lantern	flashlight
cândido	candid
interesse	interest
bolsa	bag	purse	handbag	scholarship
pâncreas	pancreas
aproveitar	take advantage	profit
definição	definition
Ontem	yesterday
arriscar	risk	gamble
falhar	fail	not happen	err
aplauso	applause
seguro	insurance	secure	safe
registro	register	record	registration
alimento	food	nutriment
acessório	accessory
apenas	only	just	merely
horário	timetable	schedule
lucro	profit	gain
gêmeo	twin
médico	doctor
intestinal	intestinal
ferido	wounded	cut	injured
cardiopata	cardiac patient
paralisação	paralysation
caridade	charity
renda	lace	income	revenue
perfil	profile
operam	operate	work	produce	function
operar	operate	work	produce	function
doente	ill	sick
depois	after	following
aplicar	apply	put into practice
integridade	integrity
limitação	limitation
jogadores	player	gambler
pobre	poor
falto	needy	lacking	deficient
aniversário	birthday	anniversary
quase	almost	nearly
extinto	extinct
transtornos	disturbance	inconvenience
difícil	difficult
comandar	command
cansaço	fatigue	tiredness
remo	oar	paddle
moção	movement	motion
alternar	alternate
lanche	snack
avenida	avenue
crise	crisis
guloso	gluttonous	fond of dainties
interceptação	interception
reto	rectum	straight	direct	plain
ruir	collapse	fall into ruin
claro	clear	bright	light	obvious	evident
equilibrado	balanced
ruim	bad	evil
mulher	woman
anos	years
torturar	torture	afflict
próximo	next	near	coming	fellow man
bola	ball
falsificação	falsification
sofisticado	sophisticated
ambiental	environmental
comunidade	community
projetos	plan	project
girar	spin	turn
organizar	organize	arrange
incidente	incident
intransitáveis	impassable
recuperar	recover	regain	restore	retrieve
espingarda	rifle
questionar	question	debate	object	wrangle
marginal	marginal	outcast	pariah
flagelo	scourge	whip	punishment
coisa	thing
calçar	shoe	boot	put on shoes
recaída	act or effect of falling back	relapse	setback
balançar	balance	sway
teórico	theorist	theoretician
popular	popular
aviso	notice	warning	sign
barril	barrel	cask	wooden keg	vat
pneumonia	pneumonia
merecer	deserve
taxista	taxi driver
abrigar	shelter	protect
bandeirinha	pennant
fruto	fruit	offspring	consequence	reward
manhã	morning
catástrofe	catastrophe
sente	feel	experience
escorregadia	slippery
proximidade	proximity	closeness
ofensivo	offensive	hurting	insulting
Foi	went
urbanização	urbanization
adaptar-se	adapt
jantar	dinner
feliz	happy
entrara	enter
múltiplo	multiple
treinador	trainer	driller
empurrar	push
dobro	double
estrangeiro	foreigner	foreign
desabrigados	unsheltered	unprotected
combinar	combine	match
descartar	discard	reject
decretar	decree	proclaim
falecer	decease	die	pass away
marrom	brown
rever	see again	review	examine	proofread
vista	sight	view
diferença	difference
torcida	cheering
ampliar	amplify	enlarge	increase	extend	widen
andamento	tempo	course
pancreatite	pancreatitis
emocionante	moving
ironia	irony
contribuir	contribute
desafio	challenge	dare
planar	plane	glide
expressão	expression
empresário	businessman
península	peninsula
demorado	delayed
tema	theme	topic
ocasionado	occasioned	caused
quilômetro	kilometre	kilometer
assalto	assault	attack	robbery
favorável	favorable
ambulância	ambulance
devastação	devastation
parte	part
superintendência	superintendency
masculino	masculine	manly	virile
preparar	prepare
propor	propose
preciso	precise	exact	concise	necessary
rival	rival	opponent
voar	fly
castigado	punished	chastised
ranhura	groove	slot	slit
legítimo	legitimate
escreveram	write
lançamento	launching
pertinente	pertinent
atrapalhar	confuse	disorder	confound	frustrate	mix up	mess up	make difficult
álcool	alcohol
trânsito	transit	traffic
Em	in
vilão	villain	rogue	scoundrel
agravar	aggravate
descer	descend	go down	lower
emissão	emission
unificar	unify
talonários	receipt book	notepad
determinação	determination
lindar	demarcate	border
taça	goblet	wineglass	trophy
informar	inform	snitch
regularização	regularization
presumível	presumable
informal	informal
autuação	filing	collection of documents for lawsuit
boa	good
floresta	forest	rainforest
terrorista	terrorist
percorrer	go through
buscar	search	seek	look for	inquire	quest	fetch	go get
grito	yell	cry	scream	shout
volta	lap	return	regress	turning	rotation
tombar	stumble	tumble	fall	overthrow
obra	work	opus
integrantes	component	constituent
independência	independence
parou	stop	cease	halt
constante	constant	persistent	steady
pavimento	pavement	floor	story
barreira	barrier	rail	bar	hurdle	checkpoint
arquivamento	filing
crédito	credit
antecipar	anticipated
ferroviário	railway employee	pertaining to railways
liderar	lead
As	the
improbidade	improbity
acessando	access
par	pair	couple	peer
mostrar	show	exhibit	display
irrepreensível	irreproachable
harmonioso	harmonious	symphonious
provisório	provisional
paz	peace
Ao	to the
abril	april
arremeter	assail	invade	assault
fogo	fire
oficial	official
repleto	replete	very full	congested
passageiros	passenger	traveller
perspectivo	perspective
acesso	access
abrir	open
bom	good
persista	persist
nuclear	nucleate	nuclear
empresa	company	firm
corrigir	correct	rectify	proofread	revise	review	grade
cidadão	citizen
obrigar	force	oblige	impose	compel
democrático	democratic
atraso	delay	lag	retardation
propulsão	propulsion
gasoduto	gas pipeline
preconceito	prejudice	bias
Km	km
atirar	shoot	throw
terremoto	earthquake
funcionar	work	operate	serve
imediatamente	immediately
salvar	save	rescue	free	protect
punição	punishment
companheiro	companion
falho	faulty	bad	defective
ilha	island	isle
parâmetro	parameter
lance	bid	stile	throwing	casting
energia	energy	power	strength
empréstimo	borrowing	loan
presença	presence
foram	went	were
importante	important
final	final
retaliação	retaliation	revenge
borboleta	butterfly
concessão	concession
castigar	chastise	punish	castigate
admissão	admission
distinto	distinct	different
cerca	fence	railing	about	around	approximate	circa
prejudicar	damage	harm
recuperação	recuperation	recovery
hepático	hepatical
feminino	feminine
consumo	consumption	use	wear	intake
tropical	tropical
gerar	generate	create
abafar	smother	asphyxiate	repress	subdue
pista	track
caminho	way	road	drive
reacender	relight	rekindle	incite
regulador	regulator	regulating mechanism	regulating
vistoria	inspection	review
Na	in the
ofender	offend	insult
inaceitável	unacceptable
defensor	defender
emitir	emit
República	republic
entrada	entrance
foco	focus
interior	interior	countryside	inner
atacar	attack	assail
medicina	medicine
minimizar	minimalize
detido	detained
nulos	null	void	invalid
imaginar	imagine	picture	figure out
atento	attentive	heedful	thoughtful
olhar	look	view	regard
cantar	sing	seduce by flattery
parque	park
proibir	prohibit	forbid	ban
missão	mission
especial	special
denúncias	denunciation
revogar	revoke	repeal	cancel	annul	recall
berçário	nursery	maternity ward
elaboração	preparation
fatal	fatal
ressalva	reservation	exception	safeguard
aparecer	appear	arise	show up	turn up
entes	being	a person	living creature
apareceu	appear	arise	show up	turn up
bem	well
inteligência	intelligence
sinal	signal	sign	light	mark
atrito	friction	rubbing	discord
chateado	upset	bothered	irritated
manobrar	maneuver	manipulate
desceu	descend	go down	lower
avançar	advance	proceed
beneficiado	beneficiary
tranqüilo	tranquil	calm	peaceful
produtividade	productivity
geral	general
ideológico	ideologic	ideological
eleger	elect
esconder	hide
falar	speak	talk	say
desculpar-se	excuse oneself	beg pardon
pânico	panic
pensar	think
refém	hostage	kidnappee
judicial	judicial
objeto	object	aim
ecoar	echo
oferta	offer	proposal
Mesa	table
escrever	write
terrorismo	terrorism
saído	left	departed
definitivamente	definitely
apimentar	pepper	spice
tributo	tribute	duty	tax
transbordar	overflow	inundate
partidário	partisan	sectarian
analista	analyst
negócio	business	dealing	affair
convite	invitation
corresponder	correspond
nuvem	cloud
saída	exit
jornalista	journalist
faltar	lack
excelente	excellent
cadáver	cadaver
escândalo	scandal
vigora	vigour	vigor
chefiar	lead	command	control
restrição	restriction	limitation	restraint
secretaria	secretariat	office	bureau
informou	inform	snitch
pular	leap	jump
tambor	drum	eardrum	cylinder
Este	this	east
Um	an
por	for	by	through	per
estudante	student
sétimo	seventh
derrota	defeat
esperar	hope	wait	expect
chegou	arrive	come closer	approach
provável	probable
bem-estar	welfare
destruiram	destroy
ocorrido	occur	happen
fator	factor
entorpecentes	narcotic
prova	proof	test	evidence
doze	twelve
altura	height
travar	restrain	impede	hamper	join	connect	brace
calibre	gauge	caliber	calibre
cruzar	cross	cruise
contemplar	contemplate	behold	gaze
carteira	wallet	purse	desk	driving license
gostar	like	enjoy
iniciar	start	begin	initiate
conclusão	conclusion
sétima	seventh
inicial	initial
derrubar	throw down	knock down	tackle	tip	drop
priorizar	prioritize
mostrou	show	exhibit	display
educação	education
prejuízo	disadvantage	injury
violência	violence
sigiloso	secret
resolver	solve	resolve	settle
parar	stop	cease	halt
eletrônico	electronic
deter	detain	deter	withhold
simbolizar	symbolize
afastar	deviate	avert	stand back	stray	ditch
canteiro	stone cutter	sculpton
vitimar	victimize
represo	dam	repress
mérito	merit
limpar	clean	cleanse
brilhar	shine
cercar	fence	surround	corral
imigrante	immigrant
arcebispo	archbishop
gestão	management
cumprimento	greeting	congratulation	fulfillment
exibição	exhibition
prosseguir	continue	proceed	carry on	pursue
comparação	comparison
checagem	checking
litoral	coast	shore
sorte	luck	chance	fortune	destiny	fate	sort
requerido	request	demand	entail	require
humano	human
momento	moment	instant
absurdo	absurd
postura	attitude	stance	posture
belo	beautiful	handsome
gol	goal
estelar	stellar
camisa	shirt
compreender	understand	realize	comprise	include	comprehend
dólar	dollar
botijão	cylinder	compressed gas container
autorizado	authorized
antes	before
coordenar	coordinate
arquibancada	bleachers	rows of seats in a stadium
progresso	progress
favela	favela	slum
inspiração	inspiration	breathing in
antecipou	anticipated
expor	expose	show	display
condado	county	authority of a count
centrada	centered	focused	centralized
assinalar	mark	brand	designate
enfermagem	nursing
renuncie	renounce	resign
semáforo	semaphore	traffic light	railway signal
climático	climatic
ficaram	stay	remain	last	endure
invasão	invasion
realizados	realized	achieved	accomplished
eliminatório	eliminatory
norma	norm	precept	rule
suspensão	suspension	hoisting
desocupação	lack of occupation	indolence
milhar	a thousand	chiliad
curva	curve	bend
vergonha	shame
bancário	banking	bank clerk	teller
esfera	sphere
sexto	sixth	sixth part
primeiro	first
estar	be
unidade	unit
significar	mean	signify
orgulhoso	proud	vain
carceragem	incarceration	imprisonment
União	union
pertencia	belong
aqui	here
religioso	religious person	religious	devout
túnel	tunnel	underground passage
bela	beautiful	belle
machucou	hurt	injure	wound
extraordinário	extraordinary
flutuar	fluctuate
oculto	occult	hidden
letra	word
charmoso	charming	graceful
evolução	evolution
usar	use	wear
competente	competent	capable
curso	course
circulação	circulation
comunista	communist
recorrer	search	scrutinize	investigate	apply for	appeal to
extremo	extreme	utmost	the end
prédio	building
inspeção	inspection
pró	pro	for	in favor of
pressionando	press	compress
paiol	storehouse	barn	bunker
retratar	portray	paint	retract	abjure
escritório	office	study
piores	worse	worst
nominal	nominal	not real
totalizar	totalize
fórum	forum
quantidade	quantity	amount
ocorresse	occur	happen
crescer	grow	expand	enlarge	develop
movido	moved	taken	caused
incapaz	incapable
habilidoso	skilful	skilled	handy	dexterous
solicitação	solicitation
telefonema	phone call
surgimento	outbreak	emerging	appearing
sofrer	suffer	grieve	endure
verdadeiro	true	real
domínio	dominion
empatar	tie
tampouco	either	neither
finta	contribution	feint	dodge
intermediário	intermediary
turno	turn	shift
aditamento	additament
conhecer	know	be familiar with	meet	get to know
norte	north
enriquecer	enrich
subterrâneo	subterranean
futuramente	in time to come	futurely
dirigir	drive	direct	control
presidente	president
chegar	arrive	come closer	approach
deliberativo	deliberative
pênaltis	penalty
intermediária	intermediary
saber	know	knowledge	learning	erudition
interromper	interrupt
novamente	again
pertencer	belong
inimigo	enemy
demorar	linger	lag	loiter	tarry	be late
robustez	robustness	strength	lustiness
atravessar	cross	traverse
instituição	institution
obter	obtain	acquire	get	gain	achieve
cá	here
resgate	rescue	redemption	liberation
aquecimento	heating	warming
relógio	watch	clock
posicionar	position
atalho	bypath	obstacle	obstruction
infundado	unfounded
açúcar	sugar
trave	beam	bar	crossbar
sair	leave	go out	quit
efetivo	effective
quarta	fourth
causar	cause	induce	bring on
ansiedade	anxiety	anguish	angst
tampo	barrel top	toilet seat cover
queimar	burn
críticos	critic
pasta	paste
parente	relative	kinsman
balcão	counter	balcony
quarto	bedroom	room	fourth	quarter
valor	value
sentir	feel	experience
desabrigo	unshelter	leave without shelter
fraude	fraud	cheating	smuggling
aberto	open
superior	superior	excellent
dois	two
suicídio	suicide
de	of	from
tomou	take	seize
conjunto	set	kit	suit	conjunct	combined	concerted	joint
analisar	analyze	investigate	think
intensivo	intensive
do	of the
afetar	affect
comemoração	commemoration
metrô	subway	underground
estadual	state
destruição	destruction
atingir	reach	hit	strike
facilidade	facility
choque	shock	surprise
em	in
es	being	person	man	woman	be	serves as	be for	absence makes the heart go yonder	the sky is the limit	anything goes	before light is coal	as is necessary	as is needed	so	when somebody is	since the world began	love is blind	the joke is that	you were warned	you were given fair warning	the rest is history	time is money	to err is human	it is true that	it is certain that	it is understandable that	conforms to	complies with	be thankful that	be grateful that	the wise remain silent	silence is golden	that is	that is to say	that is the last straw	it is evident that	it is clear that	it is the custom	it is customary	it is the same	the cure is worse than the disease	that is why	it is for that reason that	the thing is	that is all	supposing	hypothetically	such a pity	it is a shame that	this is	this is the life	attitude is everything	wrinkles are beautiful	the eyes are the mirror of the soul	the face is a mirror of the soul	the flesh is weak	coexistence is difficult	the thing is that	experience is a plus	experience is a rank in itself	people are	the idea is	fools rush in where angels fear to tread	ignorance is the mother of imprudence	the information provided is	the intention is	the intent is	not actually the case	quite another story	in fact	the responsibility lies with	health is the key	health is the most important thing	the sight of blood is shocking	is alarming	the sad reality is that	life is beautiful	the fact is that	the truth is that
aí	there
detectar	detect
tentou	try	attempt	tempt
sanguessuga	leech	bloodsucker
normal	normal	regular	natural
capaz	able	capable	competent
situar	place	situate	locate
reduto	redoubt	temporary fortification
leste	east
tinha	had
água	water
ano	year
refletir	reflect	deflect	think	ponder
campanha	countryside
da	of the
liberar	discharge	liberate	settle
responsável	responsible
Presidente	president
continuar	continue
cifra	cipher	figure
apoiar	support	back
abertura	opening
congestionamento	congestion
verdade	truth
restaurante	restaurant
véspera	eve
recente	recent
poeira	dust
psicológico	psychologic	psychological
fornecer	supply	provide
passo	pace	step	walk	gait
multiplicação	multiplication
migração	migration
escapar	escape
separado	separate	apart
escolha	choice
classificou	classify	qualify
passe	pass	permission
metro	meter	meter stick
drible	dribble
cruzou	cross	cruise
as	the
ala	line	row
ar	air
começar	begin	start
reboque	act of towing	tow truck	paster	streetwalker
relatório	report	account
incêndio	fire	conflagration	burning
boato	rumor	rumour
histórico	historical	historic
distribuidor	distributor	distributer
sangrento	bloody	bleeding	description of rare meat
imobiliário	real estate
palavra	word
no	in the
terceiro	third
suspeito	suspect	suspicious	suspected
muito	much	lot	plenty	many
espontâneo	spontaneous
inclusive	inclusive	including
sentença	sentence	judgment	verdict
guerrilha	guerrilla
lucrar	profit	benefit from	gain
regime	regime	administration	diet	regimen
identificar	identify
texto	text
triplicar	triplicate	triple	treble	multiply by three
separar	separate	part	detach
fugir	flee	run away	elope
dono	owner	proprietor	landlord
morder	bite	torment	hurt	stimulate	instigate
arrancado	jerked	jolted
trabalho	work
mãe	mom	mother
lá	there	la
fusão	fusion	amalgam	merger
mão	hand
pessimismo	pessimism
ginásio	gymnasium	gym
noroeste	northwest
petrolífera	petroliferous	bearing petroleum
presidenciável	eligible to be president
governo	government
maioria	majority
enchente	flood
plano	plan
condição	condition
cabeceira	cushion	headrest	headboard
amanhã	tomorrow
identificação	identification
cessar	cede	surrender
moto	motto	motorcycle
desfecho	outcome	conclusion
me	me
marítimo	maritime	relating to the sea
diplomacia	diplomacy
atleta	athlete
símbolo	symbol
seção	section	division	slice
na	in the
já	already	yet	ever
item	item
crer	believe
dormir	sleep
controlar	control
chamar	call	shout	convoke	name
confirmação	confirmation
balanço	audit	swinging	oscillation
minúcia	minutia	detail	nicety
dever	obligation	duty	task	homework	owe	should	must	ought to
conferência	conference	convention	talk	lecture
kg	kg
economista	economist
jogadas	scheme	plot
governar	govern	rule	command
mora	delay	respite
desenvolvimento	development	growth	progress
moro	live	inhabit
errar	err	miss
ênfase	emphasis
sudoeste	south west
quarteto	quartet
evangélico	evangelic
sucessor	successor	follower
leve	light
pressionar	press	compress
amplo	ample	wide	spacious	roomy
km	km
há	there is	there are
curar	cure
argumentar	argue	dispute
milícia	militia
relevante	relevant	significant	important
la	there	la
entendimento	understanding
agora	now	at this moment
cirurgia	surgery
artista	artist
vendedor	seller	vendor	clerk
possibilitar	enable	make possible
Ambiente	environment	atmosphere
dourado	golden
têxtil	woven	textile
monte	portion	heap	pile	accumulation
ameaçar	threaten	menace
estender	extend	spread
mês	month
prefeitura	city hall
protelar	delay	put off
identidade	identity	identicalness
lavar	wash
agenda	agenda	schedule	organizer	diary
ir	go
inovador	innovative	innovating
composto	composed	made of	composition	compound
natação	swimming
possível	possible
transformador	transformer	transforming
necessidade	necessity
tráfico	traffic	trade	shady deal
gado	cattle	stock	live stock	herd
dependente	dependent
tamanho	size	scale	dimension
cadeia	prison	jail	chain	string	strand
mandou	order	command
local	place	site	venue	local
recomendado	recommended
guerrilheiro	guerrilla
trimestral	trimestrial	every three months
cobrar	charge	bill
devolver	return	give back	refund
segurança	security	safety
avô	grandfather
aliança	alliance	wedding ring
atrasado	delayed
colar	glue	stick	paste	tape	cheat	necklace
sonoro	sonorous	resonant	loud
isolados	isolated
diário	daily
terços	a third part of anything	middle part of a ship
só	lonely	solitary	just	only
placa	sign	plate	plaque	tag
cumprir	comply	abide	accomplish	fulfill	perform	carry out
asfalto	asphalt	tarmac
piscina	swimming pool
juízo	proposition of something believed or asserted	capacity for judging
Pompeo	be pompous	act pompously	show off	flaunt
humanitário	humanitarian
festivo	festive	merry
clima	climate	ambience	atmosphere
através	through	across
estágio	stage	internship
federação	federation
anual	annual
emergência	emergency	emergence
fisionomia	physiognomy
perceber	perceive	notice	realize
evento	event	happening	occurrence
citar	cite	quote	summon
funcionamento	functioning
socorro	help	aid	assistance
surgir	appear	arise	emerge
decepcionar	disappointment
cruzamento	crossing
sanguessugas	leech	bloodsucker
conjunção	conjunction
sacudir	shake	quake	jerk	jolt	jar
revitalização	revitalization
supermercado	supermarket
potável	potable	drinkable
projeto	plan	project
refúgio	refuge	shelter	retreat
matriz	matrix	womb
colaboração	collaboration
criticar	criticize	review	judge
incompatível	incompatible
objetividade	objectivity
fabrica	plant	factory
um	an
un	an	feeling like a	by the side of	alongside	on the side	to one side	just one step away from	very close to	near to	skip a grade	induce labor induce early childbirth	commit oneself	make a commitment	make a mountain out of a molehill	a tempest in a teapot	accomplish something	achieve something	friend of a friend	be forgetful	have a bad memory	go here and there	contract addendum	score a triple	hit a triple	in front of an audience	before the authorities	considering a great opportunity	a promotion	a good or better job	facing a guy	before some guy	in front of some guy	project background	in less than a year	before the year is up	years in business	age of a car	cancel a test	disallow the goal	turn off a cell phone	put out a cigarette	show up for a minute	make text appear	put a place aside	move to one side	really want to	want very much to	enforce punishment	apply a discount	give a discount	give a test	contribute a new point of view	bank on a concept	go for a different style	apostille a birth certificate	rely on an outline	learn a whole lot	learn a ton	pass an exam	approve a tax	sign a tax into law	approve a plan	approve a project	use a space	make use of a space	make the most of a bit of free time	use some free time	get a little closer	take aim at someone	point a gun at someone	point a gun	write down a phone number	make note of a phone number	get a phone number	be game for anything	go along on a trip	sign up for a trip	join an excursion	diary entries	file a case	file a procedure	organize a catalog	prepare a catalog	set up a stage	make a mess	mess things up	get in trouble	work on a jigsaw puzzle	set up a tent	set up a canopy	mount an awning	make trouble	bite off a mouthful	pull out a hair	drag a load	carry a problem around	dress a corpse	produce a commercial deficit	produce a balance	reserve a seat	reserve a spot	give a hard punch	punch hard	deliver a blow	assign a number	assign a social security number	allocate a payment	assign a salary	set a salary	take a position	assume a post	take office	take on a new business	take care of a patient	attend to a patient	take care of a payment	treasure a memory	trapped in a dream	caught up in a dream	pass through a place	drill through a layer of soil	responsibility for a crime	move up	receive a promotion	dance like a duck	beneath a canopy of stars	underside of a vehicle	car frame	chassis	picture frame	fork in the river	ironclad contract	cargo hold	cargo compartment
alimentação	feeding	alimentation	nourishment
acima	above
para	to	for
posicionamento	positioning	position
semanal	weekly
tranqüilamente	calmly	quietly
nervoso	nervous
função	function
pé	foot
sócio	partner
abandonar	abandon
envolvimento	involvement
cooperação	cooperation
classificar	classify	qualify
deflagrar	burn	explode	deflagrate
começou	begin	start
caminhar	walk	hike
Café	coffee
indevido	undue	unjustified
povoado	settlement	village
ocasião	occasion
desencadear	unleash	unchain
gabinete	cabinet	office
exigir	demand
adolescente	adolescent
acidente	accident
ambiente	environment	atmosphere
se	if	whether	self
Quase	almost	nearly
invalidar	invalidate
discursar	make a speech
produzir	produce
natural	native	natural	character
iniciavam	start	begin	initiate
interferência	interference
notadamente	notably
opor	oppose	prevent
certeza	certainty	sureness
defensores	defender
simultâneo	simultaneous	synchronic
roupa	clothes	garment	outfit	clothing
competição	competition
lento	slow	deliberate
colocado	collocated	set
novidade	precept	rule	news
sofrimento	suffering
que	what	that
telão	big screen
indício	indication	clue	trace	symptom
viatura	vehicle	means of transport
emenda	correction	amendment
reter	keep	retain	hold back	detain
lógico	logical
executar	execute	perform	carry out
completar	complement	complete	conclude
pressupor	presuppose	assume
foto	photo	picture
desastre	disaster
torrencial	torrential
declarar	declare
pago	payment	remuneration	wages
test	test	vocational orientation test
retirado	retired	solitary	secluded
acionar	put in action
forte	strong
drama	play
explicar	explain
países	country	nation
exortar	exhort
circular	circulate	surround	move in a circle
tese	thesis
enfrentar	deal	face	confront	play against
imóvel	steadfast	firm	motionless	quiet	still
ferreira	smith	blacksmith	ironmonger
cobrir	cover	coat	veil
havia	there to be
requisitar	request	requisition	demand	solicit
impulsionar	impel
recompor	recompose	renew	give a new form to
subsídios	subsidy
pesado	heavy
foro	forum	tribunal	court
delta	delta
combustível	fuel	combustible
exame	examination	quiz	medical
liderança	leadership
assinar	sign	underwrite	subscribe
marcado	marked	distinctive	drug dealer
assessor	advisor	counselor	consultant
conhecimento	knowledge	understanding	bill of lading
problema	problem	trouble	matter
cita	cite	quote	summon
adulto	adult
loja	store	shop
teto	roof	ceiling
roubo	robbery	theft
proceder	proceed	conduct	procedure
costa	back	coast	shore
agrícola	agricultural
ensaiar	practice	rehearse
distribuição	distribution
acostumar	accustom	habituate	be used to
aproximar	near	come near	approximate
produto	product
nova	news	novelty
isso	this	that
poderoso	powerful
porquê	reason	cause
hóquei	hockey
novo	new
compromisso	commitment	engagement	liability	obligation	pledge	promise
descoberto	discovered
reclamação	complaint	demand	object
vencedora	winner	victor
conformar	conform	shape
nove	nine
fora	out	outside	except	save	flop	blunder
reiterar	reiterate	repeat
haver	there to be
Minha	my	mine
evacuar	evacuate	empty
décimo	tenth
ganho	profit	gain	lucre	earnings
convencer	convince
vazamento	leak	leakage
cálculo	calculation	computation	reckoning	mathematics	figure
psicólogo	psychologist
abadia	abbey
contido	restrained
essência	essence
feijoada	dish of beans and pork
show	show
treinar	practice	train
fabricante	manufacturer	industrialist
margem	margin	bank
desgaste	abrasion	erosion	wearing	consuming	wastage
mandado	order	writ	mandate
militar	soldier	military
fraudulento	fraudulent
fornecimento	furnishing	supplying
declaradas	declared
distanciamento	detachment	separation
obstrução	obstruction	impediment
absorção	absorption
tendência	trend	tendency	inclination	disposition
vigor	vigour	vigor
imagem	image
ativo	active	busy	energetic	vigorous
legislação	legislation
trilho	thrasher	harrow	track	trail
depender	depend	count on
duvidosa	doubtful
gravar	record	tape	engrave	carve
percentual	percentage
rodovia	highway
encobrir	cover	occult	conceal	disguise
assomar	mount	emerge
agente	agent
mural	mural	relating to a wall
além	beyond	the other world	eternity	hereafter
fome	hunger
forme	form
perder	lose	miss
beneficiar	benefit	protect
tomar	take	seize
ato	act	action	deed
cessar-fogo	cease fire
enganar	fool	trick	deceive
execução	execution	accomplishment
qualidade	quality
forma	shape	form
expansão	expansion
decidir	decide	resolve	settle
comércio	commerce	trade
intervenção	intervention
realizado	realized	achieved	accomplished
restante	rest	remainder	residue
distinguir	distinguish
chance	chance	opportunity
constituição	constitution
desejo	desire	hope	wish	will
ampliação	amplification	increase
destruir	destroy
aguardar	expect	await	wait	hold
tão	so	such	that	as	so much
intenção	intention
incentivo	incentive	incitement	encouragement
etanol	ethanol
recurso	resource	appeal
ferir	wound	injure	strike
prato	plate	dish
fez	did
subir	climb	hike	raise	rise
conter	contain	comprise	comprehend	refrain	repress
viver	live
palma	palm leaf	palm of the hand	victory
desconhecido	unknown	anonymous
multa	fine	ticket
espaços	space
inflamação	inflammation
triangulação	triangulation
facção	faction
município	municipality	city council
defender	defend
importância	importance
cópia	copy	imitation	backup
prata	silver
cheque	check	cheque
pneu	tyre	tire
básico	basic
partido	party	political organization
denunciar	denounce
emprego	usage	job
recesso	recess
grande	big
ponte	bridge
ponto	point	dot	stitch	period	full stop
precipitar	precipitate
preventivo	preventive
acusar	accuse
agressor	aggressor
tripulante	member of the crew	sailor
recentes	recent
solar	manor house	solar	sole a shoe
radioativo	radioactive
basquete	basketball
servidor	server	attendant	domestic
mínimo	minimum	minimal	least
partida	departure	match	game
façanha	achievement	exploit	feat
digestão	digestion
mover	move	cause	advance	put in motion	persuade
aldeia	village
pisar	step on	tread on
império	empire	imperium
capital	capital
negociar	negotiate	do business
abordar	approach	tackle	board
esteira	wake	treadmill	carousel	conveyor belt
comercial	commercial	add
ilegalidade	illegality
prisioneiro	prisoner
faz	does	makes
afirmação	affirmation
competir	compete
socorrer	succour	help	assist	aid
tramita	path	course	way
protocolo	protocol
eleito	elected
conhecido	known	notorious	acquaintance
lesar	injure	damage	bruise
assessoria	advisement	consideration
metálico	metallic
puxar	pull
tocar	play	touch	ring
hospitalizar	hospitalize
declarada	declared
distribuir	distribute
melhorou	improve	ameliorate	get better	recover
borracha	rubber	eraser
conquistar	conquer	vanquish	defeat	achieve	accomplish
conquistas	conquest	conquering	achievement	accomplishment
rotina	routine
obsceno	obscene
Associação	association	society
oferecer	offer
externo	exterior	outside	external
avaliar	evaluate	assess	estimate	rate
detento	prisoner
contrário	contrary	opposite	reverse	on the contrary	unlike
poupado	saved
pacto	pact	agreement	compact
remanescente	remainder	remnant	surplus
revelar	reveal	disclose	develop
rolo	roll	reel
autorizar	authorize
equipes	team
tectônico	tectonic
homenagem	homage	tribute	honor
atestar	attest	certify
arregaçar	tuck up	pin up	turn up
marca	mark	brand
oeste	west
freqüentes	frequent	often
garantia	guaranty	guarantee	warranty
destino	fate	destiny	destination
reconsiderar	reconsider	give a second thought
garantir	guarantee	ensure	warrant
atacante	aggressor	assailant
fonte	source	fountain
igual	equal	same	peer	like	alike
preparatório	preparatory
redes	net	network
cancelamento	cancellation
nacionalidade	nationality
roto	ragamuffin	shabby	tattered	ratty
dirigente	director
vagão	wagon	railway car	railway carriage
diverso	diverse	different
vantagem	advantage
armazenagem	storing	warehousing
pescador	fisherman
plataforma	platform
social	social
faixa	band	strip	stripe
palco	stage
magnífico	magnificent
adicional	additional
desarmamento	disarmament
saltar	leap	jump
ramo	branch	bough	twig	offshoot	nosegay
desaparecer	disappear	vanish
saudar	salute	greet	hail
reação	reaction
aliás	by the way	incidentally	as a matter of fact
fugitivo	fugitive	escapee
jurídico	juridical	judicial	forensic	legal
cenário	scenery	setting	landscape	view
relação	relation	listing
nota	note	check	bill	grade
quinto	fifth	fifth part	barrel	hell
Barão	baron
extraditado	one who has been extradited
profundidade	profundity	depth
descobrir	discover	find	uncover
natureza	nature
centenas	a hundred	group of a hundred
esperado	expected
protesto	protest
forçar	force
condomínio	joint ownership	condominium
médio	medium	mean	halfback
predatório	predatory
colecionar	collect
inocência	innocence
piloto	pilot
acordo	agreement	deal	understanding
úlcera	ulcer	open sore
assessorar	advise	assist	help
orientar	orient	orientate	direct	mentor
apresente	present	introduce
esboço	sketch	outline
confusão	confusion	mess	disorder
favorecer	favor	protect
complicação	complication	trouble
contar	count	tell	narrate	relate	report
palha	straw
aumentou	increase	raise	rise
recusar	refuse	disclaim	deny
oportunidade	opportunity
raro	rare	scarce	thin
observação	observation
adiantar	advance	progress	move on	be worth doing sthg
coletar	collect	gather
previstos	foreseen	expected
ponta	point	tip	end
desarticular	disarticulate	dislocate
exposto	exposed
precedente	precedent
nome	name	title	reputation	fame
comum	ordinary	common	average
modalidade	modality
agradar	please	be agreeable	appeal
votar	vote	ballot	elect	poll
expedir	dispatch	ship	issue
separadamente	separately
paralisar	paralyze
chover	rain
cabecear	beckon	nod	doze
jogar	play
comedir	moderate	restrain
retirar	withdraw	draw back
unânime	unanimous
proteção	protection
suspenso	suspended	hanging	interrupted
visitar	visit
nono	ninth
exército	army	troops	armed forces
marcar	mark	score	imprint
cereal	cereal	grain
trouxe	brought
entregues	delivered
podiam	can	may	might
dança	dance
efeito	effect
analisado	analyzed
temperatura	temperature
ouro	gold
perigoso	dangerous
emboscada	ambush
limitado	limited
conquistaram	conquer	vanquish	defeat	achieve	accomplish
baixar	lower	download	ebb
redor	circle	circuit	environs
feito	deed	done
formalizar	formalize
encontrar	find	meet	come across	stumble upon
espetacular	spectacular
estrada	road
maré	tide
população	population
suprimento	supply	subsidy	loan
efetuar	perform	accomplish
sorrir	smile
personagem	personage	character
procedente	proceeding	coming from
soltar	release
arquivar	file	shelve	register
julgamento	court session	trial
atenuar	attenuate	weaken
opositor	opponent	antagonist	candidate	opposing
resistir	resist	oppose
brusco	rough	harsh	brusque
assegurar	assure	ensure	affirm	assert	insure	guarantee
índice	index	pointer	hand	needle	table of contents
fabricação	fabrication
golpe	blow	stroke
elevado	elevated
triste	sad
mata	wood	forest	jungle
jovem	young	youth	teenager
idéia	idea
famoso	famous	renowned
agilizar	make agile
cardiologista	cardiologist
empregado	employee
útil	useful	practical	constructive
estrago	damage	harm	injury
melhorar	improve	ameliorate	get better	recover
foguete	rocket	firework
chama	act of calling	flame	blaze
rápido	fast	quick	rapids
menino	boy
aprofundar	deepen
tradicional	traditional	customary
desenvolvido	developed
consulta	consulting	consultancy	appointment
observar	observe	view	watch
jogaram	play
proposto	proposed
valer	value	worth
agricultura	agriculture
verificação	verification	examination	check	inspection
farra	binge	spree	bender
oficializar	officialize
prateleira	shelf
limitar	limit	restrict
pronto	ready	done	finished
retorno	return	coming back	callback
saque	serve	service	draft	spoil	sack	pillage
era	era	was	were	age
administrativo	administrative
recentemente	recently
telhado	roof	tiling
depositar	deposit
tempestade	storm	rainstorm
abusados	abused
vocação	vocation	calling	inclination	talent	vein
movimento	movement
sondagem	sounding	drilling	exploration
segundo	second	according
Pouco	little	few
horrorizar	horrify
acumular	accumulate
ânimo	animation	vitality	soul
arranha-céus	skyscraper
cartaz	poster	placard	billboard
ferro	iron
confissão	confession	act of confessing
residente	resident
desdobramento	unfolding	unrolling
desbloqueio	raising of a blockade
chegada	arrival
depoimento	testimony	declaration	affidavit	deposition
semelhante	fellow creature	like	similar	resembling
marcou	mark	score	imprint
litro	liter	litre
ele	he
elite	elite
tentar	try	attempt	tempt
respectivos	respective	relating to	concerning
laranja	orange
sonegação	unlawful concealment	fraud	theft
telescópio	telescope	spyglass
celeste	celestial	heavenly	ethereal
irregularidade	irregularity
ontem	yesterday
furacão	hurricane
alimentar	feed	nourish
avião	plane	airplane
susto	fright	shock	scare
propaganda	propaganda
financeiro	financial
sereno	serene	calm	tranquil
mina	mine	source of richness
libro	book	draw	issue	write out	put up	fight	be free	open book	a white paper	a ledger	bedside book	report card	mark book	grade book	reader	hardcover book	book of complaints	logbook	textbook	hardback	restore a book	be an open book	tome
golfo	gulf
prazo	deadline	term
alterado	altered	changed
desaceleração	deceleration
tornar	turn	return
vitória	victory
nível	level	plane	level surface
cravar	drive in	thrust in
desconforto	discomfort
resto	rest	remainder	remnant
portuário	dock worker	of or relating to a port
medalhar	medal
desmentir	deny
assassinato	assassination	murder
idoso	elder	senior	old	aged
crescimento	growth	increase
representar	represent	personate	impersonate	play	perform	act
errante	erring
aceleração	acceleration
esposo	husband
desconhecer	ignore	not know
dúzia	dozen
retaliar	retaliate	take revenge
implicar	implicate	imply	taunt
tribunal	court of law	judgment	jurisdiction
frisar	curl hair	be similar to
moderno	modern
licitação	bid	public tender	licitation
ação	action
melhoria	improvement	melioration
título	title	name	label	designation
recolher	collect
receber	receive
restaurar	restore
comer	eat
mentira	lie
Antes	before
helicóptero	helicopter
cuidado	care	watch out
regimento	government	administration	regiment	regime
lançar	throw	release
vela	candle
aprovar	approve	agree
acolher	welcome	receive	shelter	lodge	house
acusado	accused
escala	scale	stop over
corrida	race	racing	run
veio	shaft	spindle	arbor	axle
controle	control
política	policy	politics
decorrer	elapse	happen	occur	derive
coronel	colonel
corrente	chain	draught	draft	current	stream	flow
admissível	admissible
disfunção	dysfunction
político	politician
estabelecer	set	settle	establish
referente	referring	regarding
riqueza	wealth	riches	wealthiness	abundance	opulence
chegado	near	proximate	arrived
governamental	governmental
aflição	affliction
tenso	tense	stretched
renúncia	renunciation	resignation
estado	state
sindicância	syndication	investigation
costume	custom
diminuir	diminish	decrease	lessen	reduce	lower
fundamental	fundamental
total	total	entire
menor	lesser	smaller	younger	minor	little
menos	less
goleada	heavy defeat
provar	prove	try	test	taste
incursão	incursion	raid
onde	where
hegemonia	hegemony
beijar	kiss
entregar	deliver	hand in	betray	denounce
história	history	story
carrinho	trolley	buggy
receio	fear	dread	terror
procuradoria	procuracy
painel	panel	frame	pane
apurar	choose	select	improve
atmosfera	atmosphere
prestar	render	be useful
optou	opt	choose
estilo	style
padre	priest
corresponderam	correspond
fita	ribbon	band	tape	flick
ameaça	threat
transcrição	transcription
onda	wave
reinício	recommencement	new beginning
comparar	compare
desviar	diverge
privadas	toilet
melhor	better
câmera	camera
direção	direction	management	driving
trazer	bring	get
flagrar	burn	glow	inflame
decoro	decorum	decency
machucar	hurt	injure	wound
converter	convert
ombro	shoulder
filme	film	movie
sonegado	hidden	concealed	unpaid
Segundo	second	according
aquisição	acquisition	procurement	buy	purchase	takeover
restituição	restitution
anão	dwarf
professores	teacher	professor
auditor	auditor
frio	cold
diferente	different
enorme	enormous
chocar	shock	stun	hatch	clash	bump
canário	canary
vasto	vast	colossal
estatístico	statistician
isolada	isolated
fornecedor	supplier
turístico	touristic
desconto	discount
sociedade	society
suscetível	susceptible
acerto	hit	judgment
grave	grave	deep
revirar	turn over	turn inside out	turn upside down
realização	realization	achievement	accomplishment
sala	room	chamber	hall
tentativo	experimental	trial
são	sound	healthy	saint	are
fixo	fixed	firm
transmitir	transmit
caneco	jug	ewer
validade	validity
prerrogativa	prerogative
direita	right
engenharia	engineering
incluiu	include
desaparecido	disappeared
incluir	include
oitava	octave	group of eight
aceitar	accept
unido	united	joined	allied
registrar	register	write down	list	record
pergunta	question	interrogation	inquiry
perícia	expertise
direito	right	properly
enfrentamento	confrontation
usina	workshop	works	factory	mill	plant
distante	distant
jóia	jewel	gem
golpear	strike	beat	knock
diretoria	board of directors	direction	administration	management
luxo	luxury	splendor
preço	price
dominar	dominate
integrante	component	constituent
celebrar	celebrated
centrar	center	fix in center
confidencial	confidential	classified	private
estratégia	strategy	stratagem
central	central
gritar	scream	yell	shout
indicação	indication
distrito	district
substituição	substitution
planejar	plan
deslizar	slide	glide	slip
representante	representative
surpreender	surprise	astonish	marvel
campeão	champion
feriado	holiday
tratamento	treatment
passado	past	gone	bygone	last	latter
delegado	delegate
sobreviver	survive
ministerial	ministerial
caixa	box	cashier	register
ficar	stay	remain	last	endure
espaço	space
estabilização	stabilization
conta	count	numeration	reckoning	calculation	account	bill	check	sum
oscilação	oscillation
polêmico	contoversial
oposto	contrary	opposite
comida	food	meal
amargar	make bitter
colisão	collision	impact	crash
gosto	taste
departamento	department
desvio	diversion	detour	bypass	swerve	veering
deslizamento	slipping	sliding
similar	similar	analogous
banco	bank
infração	infraction
vilarejo	village
fuzil	flintlock	gun	rifle
contabilizar	do accounting	do bookkeeping
primeiro-ministro	prime minister
massa	dough	mortar	mass
reclamar	complain	nag
elétrico	electric
consecutivo	consecutive
assunto	subject	matter
molde	mould	pattern	norm
camarote	box	cabin on ship
máxima	maxim	precept
ilegal	illegal
duro	hard
extorsão	extortion
divulgação	publicizing
comprar	buy	purchase
receita	prescription	recipe	income	revenue
alterar	change	modify	alter
capacidade	capacity
sobre	about	over	above
acrescentar	add
assembléia	assembly
nação	nation	nationality
transtornado	disturbed	confused	perplexed
colher	spoon	pick	harvest
derrotar	defeat
máximo	greatest	highest	best	maximum
defeito	flaw	defect	fault	imperfection	deficiency
nascido	born
optar	opt	choose
insuficiente	insufficient
propenso	propense	inclined
arma	weapon	arm	gun
localizados	localized
filho	son
maior	bigger	adult	major
alertar	alert
examinar	examine
pavilhão	pavilion	canopy	banner
prioridade	priority
apreendido	apprehend	arrest
interessar	interest	concern
tentáculos	tentacle
proprietário	owner
conduzir	conduct	lead	guide
resolução	resolution
respeito	respect
técnico	technician	coach
atentar	attempt	try	venture
expressar	express	depict	show
terça	the third
diretor	director	principal	head
servir	serve	perform duties	wait on
abafado	sultry	stuffy	muffled	oppressed
vivência	life	existence	being
portador	carrier	porter
humilhante	humiliating	humiliative
qualificar	qualify	estimate	appreciate
divulgar	divulge	publish	disclose	publicize
fico	stay	remain	last	endure
fiança	guarantee	pledge	bond	surety
árvore	tree
neve	snow
arte	art	skill	craft
pensamento	thought
estatal	state
bombeiro	fireman	plumber
enfraquecido	weakened
desabafar	uncover	reveal
genocídio	genocide
retornar	return	give back	come back
chuva	rain
Não	no	not
disse	first and third person preterit form of dizer
impacto	impact	shock	hit
vencido	vanquished	overcome	subdued
dançar	dance
boletim	bulletin
conseqüentemente	consequently
faculdade	college	faculty
ceder	cede	concede	yield	give in	back away	submit	comply	remit
bastar	suffice
terrível	terrible	horrible	frightening	grisly
nunca	never
explosivo	explosive
promulgar	promulgate
transferir	transfer	transmit	communicate
devastador	devastating
motor	motor	engine
chute	kick	guess
repercutir	reverberate	recoil	deflect	throw back	report
breve	breve	brief
Rio	river
vontade	will	wish	desire
hospedar	house	lodge
repasse	pass again	drench	saturate	recall
permanente	permanent
livrar	liberate	release
penal	penal
lotar	allot	distribute
familiar	relative	kinsman	familiar	familial
edição	issue	editing
atrasar	delay	retard	defer	hinder	impede	lose time
terço	a third part of anything	middle part of a ship
terreno	terrain	ground	soil	site
solicitou	ask	beg	request	solicit
tocou	play	touch	ring
candidato	candidate
paradas	parade	stop	halt
azul	blue
determinar	determine
legenda	caption	subtitle	legend
modificar	modify
acordado	awake
eleitor	voter
começo	beginning	commencement
disputa	dispute	contest
chão	ground	earth	floor
festa	party
bastante	enough	sufficient	satisfactorily	plenty	pretty	a lot
reforma	reform	reformation	renovation
definir	define
anunciar	announce
contraproposta	counterproposal
Reportagem	newspaper report	class of reporters generally
goleiro	goalkeeper
negar	deny	negate	disavow
molhado	wet
lavagem	wash	act of washing
pintura	painting
acalmar	pacify	calm
assistir	watch	attend	be present	assist	aid	help
articular	join	link	pronounce	enunciate
luta	fight
revés	reverse	opposite side	backside
aluno	pupil
recolhimento	gathering	collecting	retirement	refuge	privacy
animal	animal
utilizar	utilize	use
convidar	invite
área	area	yard	inner	court	range	scope	field
embaixador	ambassador
colocação	collocation	emplacement	setting
cunhar	mint	stamp	emboss
bateria	battery	drum
apagar	erase	delete	extinguish	quench	damp
olé	ole
via	way	via
detonar	detonate
motorista	motorist
foi	went
reabrir	reopen
frente	front
fila	line	queue	row
vir	come
omissão	omission	neglect
introduzir	introduce
miliciano	militiaman	pertaining to a militia
excesso	excess	remainder	redundancy
alegando	allege
buraco	hole
discurso	speech
safena	saphena
mudar	change
cortar	cut	chop	clip	slice
rádio	radius	radium	radio
afastado	remote	distant
vinda	coming	arrival
velho	old
época	epoch	era	time	season
reverter	return	go back	revert	invert
isenção	exemption	act of exempting
criar	create	make	raise	nurture	breed
fortalecer	strengthen	fortify
pouco	little	few
evitar	avoid
cargo	job	post	function	situation	office	charge	duty	task
pauta	staff	list	roll	guidelines
ausência	absence
atual	present	current	going
criança	child	kid	youngster
aposentar	retire
subestimar	underestimate	underrate
oscilar	oscillate
cuidar	take care of
carga	freight	cargo	load	burden
suspender	suspend	hang	hoist
cofres	strongbox	money box	safe
velocidade	velocity	speed	fastness
fazenda	farm
industrial	industrial
lugar	place
probatório	probationary
dominou	dominate
superar	overcome	surmount
colocou	put	place	set
consumir	consume	devour	use
convicto	convict
freqüência	frequency
ajustado	adjusted	settled
clássico	classical
desembolsar	disburse	expend
pacífico	peaceable	calm	tranquil
criatura	creature
procedimento	proceeding	procedure
simular	simulate	fake	pretend
irritação	irritation
cortado	cut
fino	fine	slim
tiroteio	firing	shooting	gunfight
global	global
cancelada	canceled
cósmico	cosmic
senhor	sir	mister
droga	drug
apito	whistle
sessão	session
considerar	consider	think
destaque	highlight	prominence	eminence	distinction
cancelado	canceled
finalmente	finally
exaltar	exalt	glorify	praise
abalo	commotion
pensão	pension	allowance	alimony
gente	people	folk
encontro	meeting	shock	impact	collision
sindicalista	syndicalist	trade unionist	union member	labor unionist
explosão	explosion
lista	list	schedule
fim	end
fazer	do	make
aluguel	rent
gerador	generator
prazer	pleasure
minuta	minute	draft of a document
restavam	remain	rest	be left over	survive
serviço	service	act of serving	supply
rico	rich	wealthy
tranqüilidade	tranquility	calmness	quiet
principais	principal	main	chief
influência	influence
voz	voice
Apenas	only	just	merely
padrão	pattern	standard
participarem	participate	communicate
mistério	mystery
dissidente	dissident
dizer	say	tell	saying
atletismo	athleticism
estudantil	pertaining to a student
braço	arm	brace
tocha	torch	firebrand	stump
ângulo	angle
duelar	duel	dueling	referring to a duel
linda	pretty	beautiful	gorgeous
silêncio	stillness	silence	noiselessness
vaiou	hoot	hiss	boo
parecer	appear	seem	opinion
dentro	inside	within	indoors
time	team
ajeitou	arrange
aces	alternating current
aplaudir	applaud
bombardeio	bombardment
lindo	pretty	beautiful	handsome
discutir	discuss	argue
comentar	comment
saguão	lobby
adequado	adequate
vender	sell
manipular	manipulate
aula	class	lesson
parada	parade	stop	halt
informação	information
comercialização	commercialization
tolerável	tolerable
prorrogar	defer	postpone
protecionismo	protectionism
participante	participant	participating
conversar	chat	talk	converse
vez	turn	time
surpresa	surprise	astonishment	amazement
então	then
surpreso	surprised	astounded	amazed
ver	see	look
tributário	tributary	contributing
eletricidade	electricity
força	strength	force	power	energy	vigor
curvar	curve
conflito	conflict	discussion	war	flight
movimentados	active	busy	restless
escutar	listen	hear
terminar	terminate	finish	conclude
tripulantes	member of the crew	sailor
imposto	tax
amistoso	friendly	neighborly
troco	small change	small coin
prender	fasten	tie
instrução	instruction
urgente	urgent
racionamento	rationing	ration
base	base	foot
devoto	devout
voltou	come back	return
cultivo	cultivation
prometer	promise
ímpeto	impetus
terminal	terminal	final	ultimate
fato	fact
lidar	deal
Vai	go
firme	strong	durable	robust	stout
protestar	protest
desenvolver	develop	advance	progress
vital	vital
conquista	conquest	conquering	achievement	accomplishment
definitivo	definitive
fase	phase
excepcional	exceptional
lição	lesson
das	of the
revezamento	alternation	relay	reciprocation
motivo	motive	purpose
dar	give	bestow	donate
manobra	maneuver	military exercise
Internacional	international
disputar	dispute
malha	mesh	knitted fabric
montanhoso	mountainous
alongamento	lengthening	stretching
exercício	exercise	practice	workout
extradição	extradition
partir	leave	split	depart
encomendar	order	recommend
secreto	secret	private	hidden	occult
evitando	avoid
alma	soul
desbaratar	waste	squander
estabelecimento	establishment
matiz	tint	hue	nuance
relator	reporter	relater	narrator
dívida	debt
totalmente	totally	entirely
dentre	among	amongst
estilhaço	chip	fragment	scrap
assalariar	engage	employ	bribe
resposta	answer	response	reply
Transporte	transport	transportation
desmaiar	faint
planemos	plane	glide
patrimônio	birthright	heritage	inheritance	patrimony
hora	hour
retardar	retard	delay	slow down	postpone	prolong
ultrapassagem	overtaking	surpassingness
implante	implant
aprovação	approval	agreement
companhia	company	companion
atinge	reach	hit	strike
remanejar	rehandle	transfer	redistribute
jejum	fast	fasting	abstinence
jornal	newspaper
alcançar	reach	achieve
matou	kill	slaughter	butcher	assassinate
produtivo	productive
carro	car
hoje	today
eleição	election	polling
atrasos	delay	lag	retardation
copular	copulate
processo	process
atendimento	attendance	attending	customer service
ônus	onus	burden	charge
controlado	controlled
inundação	inundation	flood	overflow
subido	high	lofty	exalted
vizinho	neighbor
prestação	installment
virtude	virtue
tonelada	ton	tonne
maneira	manner	means	way
pessoal	personnel	staff	personal
colocar	put	place	set
perito	expert	specialist	technician
acertar	set right	adjust	regulate	hit	strike	nail
auto	document	writ	deed	act
pessoas	folk	people
privado	private
acompanhado	accompanied
responsabilidade	responsibility
visibilidade	visibility
carta	letter
necessitar	necessitate
alerta	alert
disposto	willing	eager	ready	disposed	ordered
anacrônico	anachronistic
ministro	minister
conceder	concede	grant
unificação	unification	unity
chutou	kick	guess	despise
sandália	sandal
indenização	indemnification	indemnity
responder	answer	reply	respond
motim	mutiny	rebellion	insurrection
veracidade	veracity	truthfulness
irmão	brother
espécie	species	sort	kind	specie
narcotráfico	drug trafficking
folha	leaf	sheet
promover	promote
queda	drop	fall	waterfall
inflação	inflation
intenso	intense	intensive
linha	line
sensatez	sensibleness	wisdom	prudence
cometer	commit	perpetrate
monumental	monumental
abastecimento	supply	provision
realizar	achieve	accomplish	perform	carry out
esporte	sport
garçom	waiter	server
paradeiro	stopping place
saneamento	sanitation
alcoólico	alcoholic
intransitável	impassable
covarde	coward
possuir	own	possess
cofre	strongbox	money box	safe
invencibilidade	invincibility	invincibleness
esquema	scheme
rezar	pray	supplicate	entreat
presente	present	gift
ferrovia	railroad	railway
janela	window
gratidão	gratitude	gratefulness	thankfulness
recordar	recall	recollect	remember
substituído	substituted
entrar	enter
costumar	be accustomed	used
excedente	excess	remainder
ladeiro	slanted	sideways	alongside
pratear	silver	coat or treat with silver
improvisar	improvise
anterior	previous	prior	earlier	anterior	former	foregoing
automóvel	automobile	car
notícia	notice	news item	information
relembrar	remember	recollect
alto	high	tall
graça	grace	favor	goodwill
suspensos	suspended	hanging	interrupted
agudo	sharp	acute
preocupação	worry	concern	preoccupation
pessoa	person
parcial	partisan	partial
empurra	push
nacional	national
acréscimo	addition	increase
privilegiado	privileged
eqüidade	equity
alíquota	aliquot
tipo	type	kind
tarefa	task
referência	reference
arrogante	arrogant
chocou	shock	stun	hatch	clash	bump
apreender	apprehend	arrest
livre	free
votação	voting	polling	election
abatimento	lessening	low spirits
livro	book
elemento	element
descumprir	disobey	not comply with
pesquisa	research	survey
alagar	flood	overflow
iludir	illude	deceive	mislead
mexer	stir	rummage	tease
infecção	infection
estrutura	frame	framework	structure
rendas	lace	income	revenue
apresentador	presenter
seco	shoal	dry	lifeless	uninteresting
internacional	international
orçamentário	budgetary
copa	cup	competition	top	crown	dining room
poder	can	may	might
professor	teacher	professor
modelo	model
deixar	leave	allow	let
exemplo	example	model	instance
sede	headquarters	thirst	farmhouse
deixaram	leave	allow	let
metade	half
taxa	charge	rate	tax	tuition
dimensão	dimension
acontecer	happen	occur	become
durar	last	endure
confessar	confess	reveal
quilômetros	kilometre	kilometer
condenar	condemn
estragar	ruin	spoil	damage
como	how	as	like
ajeitar	arrange
limpo	clean
milhão	million
material	material
foragido	fugitive	persecuted
arquidiocese	archdiocese
original	original	pattern	model
torre	tower	steeple	fortress
qual	which	what	that	how	as
pedofilia	pedophilia
perseguição	persecution
protocolar	protocolize	register	conforming to a protocol
turbina	turbine
morrer	die
Comitê	committee
com	with
nortista	northerner
aplicou	apply	put into practice
debater	debate
superintendente	superintendent
articulação	articulation
corredor	corridor	gangway	passage	aisle	runner	racer
resultar	result	originate or arise from	be the result
previsto	foreseen	expected
aliviado	eased	relieved
lua	moon
pênalti	penalty
rendeu	subject	subdue	conquer	vanquish
planeta	planet
tóxico	toxic	poisonous
render	subject	subdue	conquer	vanquish
adiar	postpone	defer	waive	adjourn
intercâmbio	exchange
alegria	joy	gladness	delight
comissão	commission	committee
atribuir	attribute	assign to
embaixo	under
apresentou	present	introduce
cerimonial	ceremonial
alfinetar	prick with a pin
coletivo	collective
visível	visible
ciclone	cyclone
federal	federal
transparência	transparency
trancar	lock
torno	lathe	vice	faucet
insuficiência	insufficience	insufficiency
regular	regular
nadador	swimmer	swimming
ressaltar	highlight	jut out	rebound	emphasize
voltar	come back	return
sabedoria	wisdom	learning
avisar	warn	admonish	advise	let know	inform
seduzir	seduce
regional	regional
unir	unite	join	connect	adjoin
sucessão	succession	chain	sequence	series
casal	couple	pair
movimentação	movement	moving
trabalhador	worker
despesa	expense	expenditure	disbursement	outlay
dispensa	dispensation	exemption
gozar	cum	enjoy	tease	mock
correspondente	correspondent
viagem	trip	voyage
residência	dwelling	home	abode	residence	residency	domicile
uma	an
solução	solution	answer	conclusion
impedir	impede	hinder	block	obstruct	prevent
garantido	warranted	assured
chutar	kick	guess	despise
impediu	impede	hinder	block	obstruct	prevent
procurar	search	look for
ajuda	help	aid	support	relief
compra	purchase	buy	acquisition
reduzir	reduce	diminish
barrar	plug	daub
catastrófico	catastrophic
pontuar	punctuate
parlamento	parliament
atirador	rifleman	sharpshooter
regozijar	rejoice	make merry
centímetro	centimetre
trem	train	suite	luggage
alagamento	overflow	inundation
preferido	preferred
habitação	habitation	dwelling
povo	folk	people
culpa	fault	blame
ordenar	order	ordain	command
série	series	serial	grade
afirmar	affirm	assert	claim
ligeiro	quick	swift	fast
fácil	easy	simple	common	natural
mudança	change	shift	relocation
propriedade	property
achar	find	meet	come across	think	guess
declaração	declaration
cento	hundred	the number one hundred
guerra	war
operado	surgery patient	operated
houve	there was	there were
alimentício	alimentary	alimentative
cem	hundred
bombardear	bombard
rodado	wheels of cart or carriage	track
atrás	behind	ago
pontual	punctual
Energia	energy	power	strength
melhora	improvement	melioration
território	territory	land
trajeto	stretch	length	distance	route
especializar	specialize
levantar	lift	raise	get up	stand up
compor	compose	arrange	put together
bala	bullet	toffee	taffy
interditar	interdict
lei	law
retificador	rectifier	corrector	rectified	corrected
razão	reason	ratio	motive	cause
intensidade	intensity
recomendação	recommendation
rechaçar	repulse	throw back	resist	oppose
planetário	planetarium
depreciação	depreciation
percurso	route	passage	course	trajectory
distância	distance
reunir	gather	assemble	congregate	meet
aeroportuárias	referring to the airport
acrescentou	add
bandido	bandit
triunfo	triumph
também	also	too	either	likewise
entrega	delivery	surrender
alcance	reach
província	province
refrigerante	soda	pop	refresher	soft drink
defesa	defense
status	status	condition	rank
prorrogação	deferment	prorogation
comprovar	confirm	prove	vouch
formar	form
perigo	danger	peril	hazard
formal	formal
profissão	profession
coerência	coherence
prestador	serviceable	obliging
existir	exist	occur
indicar	indicate	designate	direct	nominate
aguarda	expect	await	wait	hold
sério	serious	really	indeed
desafetos	disaffection
produção	production
concluir	conclude
herdeiro	heir	heiress	inheritor
separatista	separatist
descontar	discount
mercadoria	merchandise	goods	commodities	swag
trocar	change	exchange	substitute
redução	reduction
decisão	decision
expectativa	expectation	hope	anticipation
sabido	smart cunning fellow	known
pressionaram	press	compress
matar	kill	slaughter	butcher	assassinate
mecanismo	mechanism
reconhecimento	recognition	gratitude	reward
assaltante	assailant	robber
dispor	arrange	order	place	put
orientação	orientation	guidance
esclarecer	enlighten	clarify
estimar	esteem	appreciate	appraise	value
quebra	breakage	abatement	rebate
dado	dice	given	free	addicted to	inclined to
ônibus	bus
leito	bed	berth	cot
pódio	podium
queimado	burnt	carbonized	scorched
principal	principal	main	chief
negociação	negotiation
soberania	sovereignty	dominance	reign
reafirmar	reaffirm
nadar	swim
tremor	tremor	shiver	quake
antecedência	antecedence
requisito	requisite	requirement
vencer	win
consistir	consist	rest in
capturar	capture
rejeição	rejection	refusal	denial
acompanhar	accompany	conduct	escort	chaperon	follow up
hospital	hospital
apresentação	presentation	introduction	performance
biografia	biography
unanimidade	unanimity	unanimousness
conferencia	conference	convention	talk	lecture
desentendimento	misunderstanding
oposição	opposition
intervir	intervene
setor	sector	branch
sudeste	south east
debate	debate
lixo	garbage	trash	waste	litter	dump
mar	sea
mas	but
mal	evil	illness
abrigo	shelter	haven	covert
mau	bad
chocado	shocked	surprised	amazed
desabafo	ease	relief	alleviation
cassado	which was abrogated or repealed
quando	when
dramático	dramatic
existência	existence
beneficente	beneficent	charitable
lazer	leisure
volume	volume
usinas	workshop	works	factory	mill	plant
vestido	dress	dressed
militante	militant
fiscal	surveyor	controller	fiscal
fenômeno	phenomenon
Ainda	still	yet
hepatite	hepatitis
radioativos	radioactive
futuro	future
concordar	agree	consent
justo	precisely	exactly
explodiu	explode
namoro	relationship	love affair	love making
stress	stress
recuar	retreat	recede
disciplinar	discipline	disciplinary
permissão	permission
indicador	indicator	gauge	harbinger
cacique	cheiftain	bigwig
bebido	drink
financiamento	financing
montante	amount	sum	post	rising
ocupar	occupy	possess
internet	internet
explodir	explode
convencido	conceited	cocky	convinced
trâmite	path	course	way
desestabilizar	destabilize
artilharia	artillery
inferior	inferior
gelo	ice
reparar	repair	fix	mend	notice
madeira	wood
comover	move	touch
válido	valid	legal
mel	honey
vento	wind
igreja	church
compensação	compensation
mecânico	mechanic
somar	add	total	calculate
Sete	seven
baile	dance	ball
abaixo	below	beneath	under	down
luz	light
reator	reactor
abuso	abuse
chave	key
Calçada	sidewalk	pavement
hostilidade	hostility
colaborador	collaborator
célula	cell
pedir	ask	beg
terremotos	earthquake
destinar	put aside
vitorioso	victorious	triumphant
tráfego	traffic
nervosismo	jitters	case of nerves
âmbito	ambit	range	scope
seguido	followed	immediate	continuous
checar	check	verify	examine
chuvoso	rainy
único	unique	sole	only
empate	tie
movimentada	active	busy	restless
mensais	monthly
petróleo	oil	petroleum
suficiente	sufficient	enough
nascer	be born	rising	uprising
realidade	reality	actuality	fact
numa	in one	in a
conselheiro	counselor	councilman	adviser
aliado	ally
prefixar	prefix
plástico	plastic
atenderá	attend	serve	answer
chato	boring	dull	even	flat	plain
nulo	null	void	invalid
manifestar	manifest	reveal
encerrar	conclude	close	finish	enclose	encompass
pavimentadas	paved
universidade	university
transporte	transport	transportation
salário	wage	salary	paycheck
escalada	scaling
Dois	two
resistência	resistance	opposition
ideal	ideal
presidência	presidency
inesquecível	unforgettable
amor	love
providenciar	provide
estudar	study
cogitar	cogitate	ponder	meditate
expressivo	expressive	meaningful
deslanchar	set off
beijo	kiss
restar	remain	rest	be left over	survive
olho	eye
armado	armed	equipped
homem	man
contração	contraction
degradação	degradation
relacionar	relate	tell	enter into a relationship	compare
submeter	dominate	conquer	subordinate
fechado	closed
contemporizar	temporizer	temporizing
detalhe	detail
hectare	hectare
humildade	humbleness	humility
acostumado	accustomed	used to
concordância	concordance	agreement
edifício	building
canceladas	canceled
emendar	correct
exercer	exercise	put into practice	carry out
repetir	repeat	duplicate	hash over
exceção	exception
repetiu	repeat	duplicate	hash over
estatísticas	statistics
cutucar	poke	nudge
santo	saint	saintly	holy person	holy
operação	operation
frase	phrase	sentence
placar	placate	appease
enviar	send
autonomia	autonomy
mineral	mineral
sexual	sexual
equipamento	equipment
termômetro	thermometer
propósito	purpose	intention
recompensa	recompense	reward	prize
físico	physicist	physique	physical
pagar	pay
carregar	load	burden	carry
xingar	curse	swear
temer	fear	dread	apprehend
testemunha	witness	evidence	testimony
construtor	constructor
inscrito	inscribed
hotel	hotel
guia	guide	guidance
dor	pain	ache
sigilo	seal	secret	secrecy
consolidar	consolidate
passagem	passage	excerpt	opening	ticket
cobrança	charge	collection
desapontado	disappointed	frustrated
cela	cell
engenhar	engineer	invent	contrive
montar	mount	ride	assemble
revista	magazine	journal	muster
risco	risk	danger	hazard	scratch
montanha	mountain	large amount
revólver	revolver
ilusão	illusion	delusion
vaiar	hoot	hiss	boo
auxiliar	auxiliary	assistant	helper
regulamentar	regulate	arrange	settle	order	regulatory	referring to regulations	rules
atuação	performance	acting
anteontem	day before yesterday
perdão	pardon	forgiveness
ocorrência	occurrence	happening
provocar	provoke
manifestação	manifestation
posição	position
aéreo	aerial	air
data	date	time	period
tarde	afternoon
libertação	liberation	release
mediano	average	median
semana	week
fraudulentas	fraudulent
territorial	territorial	relating to territory
país	country	nation
exportação	exportation
reverso	reverse	backside	verso
revisto	review	revise	examine
relacionado	related
alvo	target	aim
relatar	tell	report	narrate	describe
insurgência	insurgence	insurgency	insurrection
ataque	attack	offensive	charge
industrializados	industrialized
devagar	slowly
atitude	attitude
origem	origin
adiamento	adjournment	delay	postponement
Seleção	selection	act of selecting	team of chosen players
demissão	dismissal	resignation
semestre	semester
investigação	investigation
pelo	by	for the
óleo	oil
apreensão	apprehension	arrest
desvantagem	disadvantage
desistir	give up	quit	desist
pela	by	for the
superioridade	superiority
pele	skin
garupa	croup	haunch	hindquarters
vestir	dress	clothe	garb	put on
transportar	transport	transfer	convey
adiantado	advanced
após	after	behind	past
agüentar	endure	bear	stand	put up with
esforço	effort
chefiados	led by
desestabilizou	destabilize
minoria	minority
correr	run
alternativo	alternative	optional
comunicado	communication	official report
assassinar	assassinate	kill
veículo	vehicle
membro	member
substituto	substitute
centro	center	centre	core	centrum
benefício	benefit
assumir	assume	take over	shoulder
aumentar	increase	raise	rise
epicentro	epicenter
tom	tone	pitch	hue
instalação	installation	fixture
promessa	promise
pena	feather	pity
cena	scene
situação	situation	circumstance
viaduto	viaduct	overpass
chocados	shocked	surprised	amazed
elevar	elevate
temor	fear	dread	apprehension
seriar	seriate	arrange in series
dezena	ten	set of ten
saúde	health	cheers
assustado	frightened
venda	sale	selling	grocery shop
degelo	thawing	thaw
incompleto	incomplete
vário	various	variegated	multicoloured
ganhar	win	earn
amar	love
tempo	time	weather
dano	damage
bandeira	flag	banner
consenso	consensus	consentment	agreement
Lula	squid	cuttlefish
urgência	urgency
emissor	issuing
atenção	attention
ocorrer	occur	happen
piano	piano
concreto	concrete
morto	dead	deceased	defunct
extensão	extension
presidir	preside
dia	day
morte	death
radiação	radiation	irradiation
mundo	world
diplomático	diplomatic
etapa	stage
dobrar	bend	fold	double
redondeza	roundness	rotundness	harmony	perfection
cancelar	cancel
reserva	reservation	booking	reserve
assustador	scary	frightening	creepy
análise	analysis
complicar	complicate	entangle	become complicated
constatar	verify	certify	testify
dez	ten
fenda	slit	opening	rip
imprescindível	vital	necessary	indispensable	must
tirar	take	remove
verão	summer
reassumir	reassume	retake	recover
erradicar	eradicate
terapia	therapy
instalar	install
rejeitar	reject	deny
impressionante	breathtaking	impressive
ouvir	listen	hear
equivalente	equivalent
bônus	bonus
fundar	lay the foundation	set up	establish
busca	pursuit	quest	search
supostamente	supposedly
revogação	revocation	repeal	annulment	cancellation
secundário	secondary	secondary education
aeroportuário	referring to the airport
aeronave	aircraft	airship
driblar	dribble
presídio	presidio	fortress
igualdade	equality	equalness
telefônico	telephonic
autoridade	authority
fraco	weak
contribuição	contribution
número	number
acabar	finish	end
localizar	spot	localize	locate
batalha	battle
recinto	enclosure	precinct	sanctuary
construção	construction	building
estréia	premiere	first of anything	opening
região	region	zone	district
dividir	divide	share
peso	weight
obedecer	obey
estabilidade	stability
pintado	painted
ter	have
morador	resident	dweller	inhabitant
balístico	ballistic
desempenho	performance
predisposição	predisposition
miniatura	miniature
milímetro	millimeter
conseguir	obtain	achieve	get
caber	fit	be proper	suitable
ordem	order	command
temporário	temporary	provisional
remeter	remit	send	consign
tragédia	tragedy
telefonar	telephone	phone
exibir	exhibit	show	display
decisivo	decisive
bronze	bronze
desmoronar	knock down
lado	side
entrou	enter
renunciar	renounce	resign
