infra-estrutura	infrastructure
contudo	nevertheless	however	yet
ponderar	ponder
Aéreo	air	aerial
proporção	proportion
verde	green
repórter	reporter
junto	united	joined	near	next to	along	together	close
direto	direct	straight
represália	retaliation	revenge	reprisal
conseqüência	consequence
esgotar	use up	drain
diligência	diligence	investigation
verificar	examine	check	verify
componente	competent	component
crítico	critic
contribuinte	contributor
responsabilizar	consider responsible	make responsible
gasolina	gas	gasoline	petrol
segurar	grasp	insure	make safe	make secure	hold
maquiar	take fraudulently
anúncio	placard	announcement	advertisement	add	notice
descanso	ease	relaxation	rest
disposição	nature	disposal	tendency	mood	aptitude	inclination	disposition	temper
burocrático	bureaucratic
contrapartida	counterpart	opposite
instrumento	instrument
abdicar	abdicate	renounce
não	not	no
morar	inhabit	live
autoria	authorship
moral	moral	ethical	morality
A	the
década	decade
inundar	inundate	flood
O	the
estimado	esteemed	appreciated
perfeito	perfect
resumir	abridge	summarize
infantaria	infantry
deslocar	dislocate
seguiu	follow
fluxo	flux	ebb	flood	flow
seguir	follow
clicar	click
porta	door
g	symbol of gram	the letter g
e	and
esse	that
a	the
medida	measure	measurement
caótico	chaotic
doméstico	domestic
acessar	access
comprometer	commit	promise	oblige
o	the
recado	message	word
m	symbol of meter	the letter m
arquipélago	archipelago
transação	deal	transaction	business
respeitar	venerate	honor	respect
h	hour symbol
diocese	diocese
porto	port	harbor	haven
esportivo	sportive
vaga	vacancy	opening	space
r	the letter r
resgatar	redeem	rescue	ransom
mutação	change	mutation
Fez	did
zona	zone
extratos	statement	extract
fuga	flight	retreat	subterfuge	escape
língua	tongue	language
avaliação	estimation	assessment	evaluation
cabo	cable
coluna	spine	post	column
trimestre	trimester	quarter
roubar	rob	steal
interdição	interdiction
demonstrar	demonstrate	show
turista	tourist
pretender	mean	intend
administrar	direct	conduct	administer	manage
roubadas	robbed	stolen
ladrão	thief	robber
ª	the
cronograma	chronogram
fechar	close
juntar	merge	join
quesito	enquiry	query	question	subject or issue
colunista	columnist
Treze	thirteen
massacre	massacre
º	the
Aeroporto	airport
cassação	abrogation	repeal	act of cancelling or annulling
largura	breadth	wideness	broadness	width
reunião	meeting	reunion
meteorologista	meteorologist
dificuldade	difficulty
precaução	precaution
É	and
recair	fall back	suffer setback	relapse
documentação	documentation
sobrar	exceed	overabound	be in excess
especialista	specialist
pequeno	little	small
ajuizamento	judgment
publicar	publish
categoria	category
opinar	think	judge	opine
certamente	surely	undoubtedly	unquestionably
grau	degree	grade
meia	sock	stocking	number six
somente	just	solely	only	merely
concentrar	concentrate
desligar	turn off	disconnect	shutdown
vôos	flight
meio	means	middle
noticiário	news section of newspaper	news service	news
caco	shard	potsherd
profissional	professional
canalha	scoundrel	villain
é	it is
mensagem	message
magnitude	magnitude
estourar	shatter	split	burst
à	to the
medalha	medal
queixa	complaint
público	public
vaca	cow
encaminhar	conduct	forward	lead
invadir	invade
organização	organization	group
pequena	little	small
agressivo	aggressive
representação	representation
cumprimentar	salute	compliment	greet
acusação	accusation
localidade	locality
juntos	united	joined
junção	junction
longe	far away	far off	distant	far
promotor	promoter
disponível	available
reabertura	reopening
seqüência	sequence
frear	brake
velório	wake
longo	lengthy	long
governador	governor	ruler
enviado	envoy
tramitação	normal course through legal channels
bloqueada	blocked
aprimorar	improve	perfect
pedido	request	petition	solicitation
disparar	shoot	discharge	fire
tentavam	try	attempt	tempt
fiscalização	control	supervision	inspection
possibilidade	possibility
ética	ethics
envio	shipment
branco	white
temporada	season	period of stay	period
superação	surmounting	act or effect of overcoming
prejudicado	damaged
efetivos	effective
iminente	imminent	impending
estômago	stomach
todo	entire	whole	all
inadequado	inadequate
reagir	respond	resist	react
colega	peer	colleague	mate
profundo	deep
reservista	member of the military reserves	reservist
demais	too much	excessive
simples	clear	evident	simple	plain
pressão	pressure
opinião	opinion
indignação	indignation
travado	joined	connected	linked
eventual	fortuitous	occasional
muro	wall
brincar	amuse	toy	play	joke	entertain	fun	fool
lutar	fight	struggle
trabalhar	work	strive	struggle	perform
mandato	order	mandate	trust
decolar	take off
sensação	sensation
adversário	adversary
teste	test	experiment	qui z
desvalorização	devaluation
companhias	companion	company
intelectual	intellectual
sistema	system
comandante	commander
regularizar	make uniform	regularize	rectify
habilidosos	skilled	dexterous	handy	skilful
quebrar	break	crack	fracture
subúrbio	suburb	outskirts	environ
tentação	temptation
dupla	duo
quadrado	square
quadro	square	board	picture frame
virar	turn
estocar	stock
rebelde	deserting	deserter	insurgent	rebelling	rebel
gestual	gestural
obstruir	impede	obstruct
conselho	board	council	advice	warning
mesa	table
decorrente	deriving	resulting from
ciclo	cycle
mero	simple	jewfish	mere
dita	aforementioned
vaia	derision	hissing	hoot
assim	therefore	so	thus	thereby	in this manner
vazamentos	leakage	leak
jogo	gamble	bet	play	game	match
preferir	prefer
seleção	team of chosen players	act of selecting	selection
bagagem	baggage
trégua	pause	truce	armistice
critério	criterion
ídolo	idol
vitórias	victory
vale	dale	vale	valley
código	code
danificados	damaged
sobrevivência	survival
meteorológico	meteorological
cachorro	dog
diálogo	dialogue
alegar	allege
rio	river
realmente	truly	really	actually
esperança	expectation	hope
arrancar	jerk away	pull or tear away from
dormitório	dormitory
justiça	justice
capitão	captain
ginasta	gymnast
prático	practical	functional
duplo	double
calor	warmth	heat
cidade	town	city
prever	calculate	foresee
aeroporto	airport
calou	quieten	silence	hush up	shut up
quadra	court	quartet
estádio	stadium
recomendar	praise	commend	recommend
reconhecer	acknowledge	recognize
cardíaco	cardiac
admirável	admirable
avenidas	avenue
amigo	friend
mercado	market	marketplace	commerce
documentos	document
metropolitano	metropolitan
ritmo	beat	cadence	rhythm
músico	composer	player	singer	musician
advogado	attorney	lawyer
gástrico	gastric
samba	samba
comandara	command
prefeito	mayor
realista	realist
plenário	plenary assembly
estável	stable
acontecido	happening	occurrence
voltaram	return	come back
sobretudo	overcoat	coat
perto	near	close
querer	wish	want
requerer	request	entail	require	demand
insignificante	insignificant
confundir	perplex	confuse
criação	creation	upbringing	raising
favor	favor
preso	convict	captive	prisoner
espalhar	spread
objetivo	objective	aim	goal
durante	during
ajudar	help
universitário	universitarian
paciência	patience
meta	aim	target	wicket	goal
atualmente	at present	currently	presently
intensificar	intensify
Senado	upper house of legislature	senate house	senate
vôlei	volley
entender	understand
preto	black
vivo	alive	living
pico	apex	peak
desabrigar	leave without shelter	unshelter
sentido	meaning	sense
documento	document
exorbitantes	exorbitant
dinheiro	money
liquidação	clearance	sale
etnia	ethnic group
sigla	initials	monogram	abbreviation
revisão	revision	reform	proofreading	review
provisão	supply	provision
irá	will go
órgão	organ
laudo	appraisement	expert opinion	report	appraisal
preservação	preservation
vara	staff	rod	stave	stick	pole	cane	switch
cara	face	dude	guy	man
hipótese	hypothesis
praticar	practice	exercise
destacar	detach	feature	emphasize	highlight
sobrepor	put on or upon	superpose
corrupção	corruption
errado	mistaken	wrong
processamento	processing
atômico	atomic
míssil	missile
reivindicar	regain	reclaim	recover	claim formally
casa	house
delegacia	police station
barato	cheap
preliminar	preliminary
monitorar	monitor
caso	affair	if	case	instance
extração	extraction
violento	violent
detonação	detonation
rua	street
ganhador	winner	conqueror
reversão	reversion	reversal
visa	vision
indignado	indignant
baixo	short	bass	down	low
decorrência	consequence
votado	approved	voted
atentado	attempt	assault	attack
abusos	abuse
ginástico	gymnastical	gymnastic
necessário	necessary
acaso	luck	chance
nomear	call	name
jeito	aptitude	way	manner	aptness
suposto	supposition	presumption
escolher	choose
embalar	wrap
início	beginning	opening
rebelião	insurrection	rebellion	mutiny
indiciar	indict	accuse
suposta	supposition	presumption
passageiro	passenger	traveller
gesticular	make gestures	gesticulate
acreditar	believe
admitir	admit
recibo	receipt
bater	beat	strike	knock	hit	spank
estrela	star
raiva	fury	anger	rage
ocupante	occupier	occupying	occupant
captar	catch	capture	collect
comunicação	communication
deputado	representative	deputy
participar	communicate	participate
acidentar	cause an accident
flutuante	fluctuating
objeção	objection	opposition
acidental	unexpected	accidental
tremer	tremble	shake	quake	shiver
estender-se	be enlarged	widen	extend	dilate	stretch	expand
autenticidade	authenticity
desejar	desire	wish
pancada	knock	blow	collision	shock
tratar	deal with	treat
cabeça	head
conflituoso	conflictive	conflicting
autor	author
ambos	both
cheio	packed	full	filled up	crowded
Copa	cup	dining room	crown	top	competition
danificadas	damaged
escalar	scale	climb by	escalade
jogador	gambler	player
reparo	restoration	mending	repair
multinacional	multinational
soma	total	soma	sum
tripulação	personnel	crew
cultura	culture
especialidade	speciality
filmar	film	shoot
supostas	supposition	presumption
Ele	he
mandar	order	command
artístico	artistic
prol	in favor of
eliminou	eliminate
construir	construct
singelo	sincere	artless	simple	plain
presidencial	presidential
emoção	emotion
apelido	nick	nickname
peça	play	piece
chocante	shocking	scandalous
cocaína	cocaine
procurador	procurator	attorney
telefone	telephone
desmatamento	deforestation
comemorar	commemorate	celebrate
vítima	victim
comportamento	behavior
página	page
disparou	shoot	discharge	fire
discussão	argument	discussion	debate	quarrel
contrato	covenant	contract	indenture
caiu	fell
chega	reprimand	censure	rebuke	enough
levantamento	survey	raising	weightlifting	lifting
andar	ride	walk
leão	lion
posto	position	post	place
apoio	support	basis	base	foundation
reforçar	reinforce	strengthen
cair	fall	drop	decline	decay
viciadas	addict	fiend
calar	quieten	hush up	silence	shut up
assinante	signatory	subscriber
combater	flight	combat
apontar	point	appoint	sharpen
pesar	weigh	sadness
bonito	beautiful	handsome
medir	measure
chefe	boss	head	chef	chief
comparecer	attend	report	show up
denunciados	defendant
prevenção	prevention
morreram	die
torcedor	twister	athletic fan	winding	twisting
turismo	tourism
enterro	burial
noite	night
soer	be accustomed	accustom	habituate	be habituated
centena	group of a hundred	a hundred
corpo	body
econômico	thrifty	economic
vacinação	inoculation	vaccination
falência	bankruptcy
característico	characteristic
entrevista	interview
traficante	dealer	swindler	trader	trafficker
episódio	episode
sobrevivente	surviving
aumento	raise	rise	enlargement	increase	enlarging
gesto	gesticulation	gesture
folgar	be at ease	rest	repose
impor	saddle	impose
desligado	switched off
posse	possession	ownership
sinalizar	signalize
pior	worse	worst
imprevidência	improvidence	imprudence
erro	mistake	error
ativistas	activist
obstáculo	obstruction	blockage	hindrance	obstacle
agir	take action	act
apresentado	presented
eleitoral	electoral
madrugada	dawning	late night	daybreak
harmonia	harmony
agravamento	aggravation	worsening
rivalidade	rivalry	opposition
continental	continental
humanidade	humanity
assassino	assassin	murderer
limite	limit	border
fantasmas	phantasm	spirit	phantom	ghost
instância	instance
romper	break	rupture	break through
retomar	take back	retrieve	recover
caído	fallen	decayed	decrepit
disparo	shot
perda	loss
perguntar	query	question	ask	interrogate
estufar	stew	put in greenhouse	heat
fórmula	prescription	formula
almoço	lunch
pobreza	poverty
estudo	act of studying	study	learning
alteração	alteration	change
impecável	impeccable
ilhar	insulate	confine	isolate
envolver	enclose	involve	surround
comerciante	dealer	merchant	trader
lentidão	slowness
especificar	specify
escola	school
expresso	clear	express train	express
canal	riverbed	canal	channel
notoriedade	notoriety
questionário	questionnaire
questão	controversy	matter	dispute	issue	debate	question
simpatia	compatibility	affection	liking
sim	yes
especulação	speculation
zoneamento	zoning
classificação	classification
bloquear	block
manter	maintain	keep
parafuso	screw
vídeo	video
fechamento	shutting or locking up	closure
averiguar	inquire	investigate
gás	gas	vapor	fume
titular	call	give a title	noble person	entitle	titular
chamado	convocation	summoned	called	calling
noticiar	inform	report
torneio	refinement of form	tourney	turning	joust
caráter	character
confirmar	approve	sustain	affirm	homologate	sanction	confirm
executivo	executive
salarial	of or referring to salaries or wages
ligado	tied together	connected
permanecer	remain
antiga	old	antique
paróquia	parish	city district
resíduo	residue
amarrado	tied up
meia-noite	midnight
regra	law	standard	norm	rule	decree	regulation
liberação	liberation	release
ser	be	being
rasteiro	humble	creeping	crawling	low	modest
féria	workday	rest	wages	repose
aviação	aviation
aéreos	air	aerial
suplente	proxy	substitute
antigo	old	ancient	antique
vida	life
comando	order	command	act of command
traiçoeiro	traitorous	treacherous	perfidious
legitimidade	legitimacy
acompanhamento	side order	escort	trimming	accompaniment	side dish
matéria	matter	subject
frango	chicken
delinqüente	delinquent
bairro	neighborhood	borough	district
tijolo	brick
salto	waterfall	cataract	shoe heel	hop	leap	jump
computador	computer
São	are	sound	healthy	saint
transferência	removal	transference	change	transferral
influenciar	influence
denúncia	denunciation
custar	cost
candidatura	candidacy
agitado	agitated	excited
finalizar	finalize
levar	take	carry	lead	go
programa	program
serrar	saw
recorrente	recurrent	happening again
preocupado	concerned	worried	preoccupied
reservatório	reservoir	receiver	store	deposit
urbano	urban
constitucional	constitutional
som	sound	manner	tonality
avanço	headway	advancement	advance
cervejaria	brewery
terra	land	earth
Igreja	church
avais	guaranty	surety
inversão	inversion
fundo	bottom	back	deep
pediram	beg	ask
danificar	damaged
deputar	depute	delegate
pendular	swinging	pendular
coragem	bravery	courage
cartão	cardboard	card	calling card
recorde	record	accomplishment	feat
mestre	master
instruir	instruct
calcular	calculate
salientar	point	stress	emphasize
feio	ugly
polar	polar
rachadura	cleaving	crack	fissure	splitting
escanteio	corner
efusão	effusion
consciência	perception	consciousness	awareness	conscience
Império	imperium	empire
equipe	team
faturar	charge	bill	invoice
campo	field	countryside	interior	area
craque	expert
líder	leader
reformar	reform	remodel
período	period
investigar	investigate
publicação	publication
causa	process	lawsuit	cause	reason	motive	case
funcionária	clerk	official	employee
experiência	experience
perna	leg
tigre	tiger
funcionário	clerk	official	employee
Todos	everyone	everybody
bloqueio	block
ligar	call	tie	start	link	care	bind
grupo	group
transmissão	transmission
polícia	police
paroquiano	parishioner	parochial
três	three
abaixar	turn down	lower
futebol	football	soccer
semifinal	semifinal
relativo	relative
secretário	secretary
espacial	spatial
agência	agency
rede	net	network
preocupar	worry
combate	combat
fabricar	manufacture	fabricate
autorização	authorization
líquido	liquid
permitir	allow	permit
específico	specific
sugerir	suggest
eliminar	eliminate
significativo	significant	significative
real	real	royal
propina	gratuity	tip
precipitado	hasty	hurried
resultado	result	effect	consequence
previsão	forecast	prediction
homicídio	homicide
alusão	allusion
tramitar	follow legal channels
repartição	partition	department	branch	section
ainda	still	yet
assinatura	signature
união	union
nevoeiro	fog	mist
lotação	allotment	capacity
transformar	transform	change	alter
dificultar	hamper	embarrass	raise difficulties
empenho	exertion	endeavor
liberdade	liberty
rumo	course	route	direction	bearing
favorito	pet	favorite	fondling
astrônomo	astronomer
rendimento	profit	return	revenue
pagamento	disbursement	payment
consultoria	consultancy	consultant
precisar	need	necessitate	require	demand
delegar	authorize	delegate
democracia	democracy
favorita	pet	fondling	favorite
intervalo	break	interval	lapse	recess
parlamentar	parliamentary	negotiate a truce	parliamentarian
crime	crime
próprio	own	proper
potência	potency	power
freqüente	often	frequent
maravilhoso	wonderful
gordura	fat
continuidade	continuity
tensão	strain	stress	tension
espalhado	scattered
retórico	rhetor	orator	rhetorician
estreante	novice	debutant	beginner
congestiva	congestive
figura	picture	figure
eclodir	emerge
família	family
civil	civilian	civil
complexo	complex
trecho	distance	interval	stretch	period	section
estação	season	station
oito	eight
reportagem	newspaper report	class of reporters generally
balançou	balance	sway
ministério	ministry
religar	retie	bind again	rejoin
conforto	comfort
passar	surpass	exceed	pass
tirania	despotism	tyranny
segredo	secret	confidential
porta-voz	spokesperson
repressão	suppression	repression
artigo	article	composition
comício	rally	meeting	demonstration
comoção	disturbance	commotion	riot
pedalar	pedal
fábrica	plant	factory
jogado	half dead	abandoned
formação	education	formation
percorrido	go through
binário	binary
cerimônia	rite	ceremony
completo	entire	complete
jogada	scheme	plot
sobreviventes	surviving
implantar	implant
greve	strike
seguinte	following	next
bomba	bomb	pipe
fumaça	smoke
relato	narration	report	account
concorrer	rival	compete
sul	south
pontes	bridge
administração	administration
panorama	panorama
vinculado	entailed	linked	bound
severo	rigid	severe
configurar	configure
ofício	craft	trade	art	workmanship
vôo	flight
descarrilar	derail
peito	breast	chest
prevaricação	prevarication
crucial	crucial
sustentação	maintenance	sustenance
requerimento	formal petition	application
simplesmente	simply
sugestão	suggestion
emparelhar	pair up
saldo	balance	rest	outcome
informante	informer	informant
refugiado	fugitive	displaced person	refugee
Depois	after	following
transbordamento	inundation	overflow
associação	society	association
participação	participation
democrata	democrat
bolso	pocket
renal	relating to the kidneys	renal
fiscalizar	control	subject to fiscal control	examine	check
confiança	belief	faith	trust	confidence
criminal	criminal
convocar	summon	convoke
falso	untrue	false
apresentar	present	introduce
lanterna	lantern	flashlight
cândido	candid
interesse	interest
bolsa	handbag	purse	scholarship	bag
pâncreas	pancreas
aproveitar	take advantage	profit
definição	definition
Ontem	yesterday
arriscar	risk	gamble
falhar	fail	not happen	err
aplauso	applause
seguro	insurance	safe	secure
registro	register	record	registration
alimento	food	nutriment
acessório	accessory
apenas	just	only	merely
horário	schedule	timetable
lucro	profit	gain
gêmeo	twin
médico	doctor
intestinal	intestinal
ferido	injured	wounded	cut
cardiopata	cardiac patient
paralisação	paralysation
caridade	charity
renda	lace	income	revenue
perfil	profile
operam	operate	work	produce	function
operar	operate	work	produce	function
doente	ill	sick
depois	after	following
aplicar	apply	put into practice
integridade	integrity
limitação	limitation
jogadores	gambler	player
pobre	poor
falto	deficient	needy	lacking
aniversário	birthday	anniversary
quase	almost	nearly
extinto	extinct
transtornos	disturbance	inconvenience
difícil	difficult
remo	oar	paddle
cansaço	tiredness	fatigue
comandar	command
moção	movement	motion
alternar	alternate
lanche	snack
avenida	avenue
crise	crisis
guloso	fond of dainties	gluttonous
interceptação	interception
reto	direct	rectum	plain	straight
ruir	fall into ruin	collapse
claro	clear	obvious	evident	bright	light
equilibrado	balanced
ruim	bad	evil
mulher	woman
anos	years
torturar	afflict	torture
próximo	near	next	coming	fellow man
bola	ball
falsificação	falsification
sofisticado	sophisticated
ambiental	environmental
comunidade	community
projetos	project	plan
girar	turn	spin
organizar	arrange	organize
incidente	incident
intransitáveis	impassable
recuperar	regain	restore	retrieve	recover
espingarda	rifle
questionar	debate	wrangle	object	question
marginal	pariah	marginal	outcast
flagelo	punishment	scourge	whip
coisa	thing
calçar	boot	put on shoes	shoe
recaída	setback	relapse	act or effect of falling back
balançar	balance	sway
teórico	theoretician	theorist
popular	popular
aviso	sign	notice	warning
barril	wooden keg	vat	barrel	cask
pneumonia	pneumonia
merecer	deserve
taxista	taxi driver
abrigar	shelter	protect
bandeirinha	pennant
fruto	fruit	reward	consequence	offspring
manhã	morning
sente	feel	experience
catástrofe	catastrophe
escorregadia	slippery
proximidade	proximity	closeness
ofensivo	insulting	hurting	offensive
Foi	went
urbanização	urbanization
adaptar-se	adapt
jantar	dinner
feliz	happy
entrara	enter
múltiplo	multiple
treinador	driller	trainer
empurrar	push
dobro	double
estrangeiro	foreigner	foreign
desabrigados	unprotected	unsheltered
combinar	combine	match
descartar	reject	discard
decretar	proclaim	decree
falecer	pass away	die	decease
marrom	brown
rever	examine	see again	proofread	review
vista	sight	view
diferença	difference
torcida	cheering
ampliar	enlarge	widen	extend	increase	amplify
andamento	course	tempo
pancreatite	pancreatitis
emocionante	moving
ironia	irony
contribuir	contribute
desafio	challenge	dare
planar	plane	glide
expressão	expression
empresário	businessman
península	peninsula
demorado	delayed
tema	topic	theme
ocasionado	occasioned	caused
quilômetro	kilometre	kilometer
assalto	robbery	assault	attack
favorável	favorable
ambulância	ambulance
devastação	devastation
parte	part
superintendência	superintendency
masculino	virile	masculine	manly
preparar	prepare
propor	propose
preciso	concise	exact	necessary	precise
rival	opponent	rival
voar	fly
castigado	chastised	punished
ranhura	groove	slit	slot
legítimo	legitimate
escreveram	write
lançamento	launching
pertinente	pertinent
atrapalhar	make difficult	mess up	confound	disorder	confuse	frustrate	mix up
álcool	alcohol
trânsito	traffic	transit
Em	in
vilão	scoundrel	villain	rogue
agravar	aggravate
descer	go down	lower	descend
emissão	emission
unificar	unify
talonários	notepad	receipt book
determinação	determination
taça	trophy	goblet	wineglass
lindar	demarcate	border
informar	inform	snitch
regularização	regularization
presumível	presumable
informal	informal
autuação	collection of documents for lawsuit	filing
boa	good
floresta	forest	rainforest
terrorista	terrorist
percorrer	go through
buscar	inquire	fetch	search	quest	go get	look for	seek
grito	scream	yell	shout	cry
volta	regress	rotation	return	lap	turning
tombar	stumble	fall	overthrow	tumble
obra	work	opus
integrantes	component	constituent
independência	independence
parou	stop	cease	halt
constante	constant	persistent	steady
pavimento	story	floor	pavement
barreira	barrier	rail	checkpoint	hurdle	bar
arquivamento	filing
crédito	credit
antecipar	anticipated
ferroviário	pertaining to railways	railway employee
liderar	lead
As	the
improbidade	improbity
acessando	access
par	peer	pair	couple
mostrar	display	show	exhibit
irrepreensível	irreproachable
harmonioso	symphonious	harmonious
provisório	provisional
paz	peace
Ao	to the
abril	april
arremeter	assault	invade	assail
fogo	fire
oficial	official
repleto	replete	very full	congested
passageiros	passenger	traveller
perspectivo	perspective
acesso	access
abrir	open
bom	good
persista	persist
nuclear	nuclear	nucleate
empresa	firm	company
corrigir	correct	rectify	grade	proofread	revise	review
cidadão	citizen
obrigar	impose	force	compel	oblige
democrático	democratic
atraso	lag	retardation	delay
propulsão	propulsion
gasoduto	gas pipeline
preconceito	prejudice	bias
Km	km
atirar	throw	shoot
terremoto	earthquake
funcionar	serve	work	operate
imediatamente	immediately
salvar	free	save	rescue	protect
punição	punishment
falho	faulty	bad	defective
companheiro	companion
ilha	isle	island
parâmetro	parameter
lance	stile	casting	bid	throwing
energia	strength	power	energy
empréstimo	borrowing	loan
presença	presence
foram	were	went
final	final
importante	important
retaliação	retaliation	revenge
borboleta	butterfly
concessão	concession
castigar	chastise	punish	castigate
admissão	admission
distinto	different	distinct
cerca	railing	fence	about	approximate	circa	around
prejudicar	damage	harm
recuperação	recovery	recuperation
hepático	hepatical
feminino	feminine
consumo	intake	consumption	use	wear
tropical	tropical
gerar	generate	create
abafar	repress	asphyxiate	subdue	smother
pista	track
caminho	drive	way	road
reacender	incite	rekindle	relight
regulador	regulating	regulator	regulating mechanism
vistoria	inspection	review
Na	in the
ofender	offend	insult
inaceitável	unacceptable
defensor	defender
emitir	emit
República	republic
entrada	entrance
foco	focus
interior	countryside	interior	inner
atacar	assail	attack
medicina	medicine
minimizar	minimalize
detido	detained
nulos	invalid	void	null
imaginar	picture	imagine	figure out
atento	attentive	thoughtful	heedful
olhar	look	regard	view
cantar	sing	seduce by flattery
parque	park
proibir	ban	forbid	prohibit
missão	mission
especial	special
denúncias	denunciation
revogar	revoke	repeal	recall	cancel	annul
berçário	maternity ward	nursery
elaboração	preparation
fatal	fatal
ressalva	exception	reservation	safeguard
aparecer	arise	appear	turn up	show up
entes	living creature	being	a person
apareceu	arise	appear	turn up	show up
bem	well
inteligência	intelligence
sinal	sign	mark	signal	light
atrito	friction	discord	rubbing
chateado	bothered	upset	irritated
manobrar	manipulate	maneuver
desceu	go down	lower	descend
avançar	proceed	advance
beneficiado	beneficiary
tranqüilo	calm	tranquil	peaceful
produtividade	productivity
geral	general
ideológico	ideological	ideologic
eleger	elect
esconder	hide
falar	say	speak	talk
desculpar-se	excuse oneself	beg pardon
pânico	panic
pensar	think
refém	kidnappee	hostage
judicial	judicial
objeto	aim	object
ecoar	echo
oferta	proposal	offer
Mesa	table
escrever	write
terrorismo	terrorism
definitivamente	definitely
saído	departed	left
apimentar	spice	pepper
tributo	tax	duty	tribute
transbordar	inundate	overflow
partidário	partisan	sectarian
analista	analyst
negócio	affair	dealing	business
convite	invitation
corresponder	correspond
nuvem	cloud
saída	exit
jornalista	journalist
faltar	lack
excelente	excellent
cadáver	cadaver
escândalo	scandal
vigora	vigor	vigour
chefiar	control	command	lead
restrição	restriction	restraint	limitation
secretaria	office	secretariat	bureau
informou	inform	snitch
pular	leap	jump
tambor	cylinder	eardrum	drum
Este	east	this
Um	an
por	per	for	by	through
estudante	student
sétimo	seventh
derrota	defeat
esperar	expect	wait	hope
chegou	arrive	come	closer	approach
provável	probable
bem-estar	welfare
destruiram	destroy
ocorrido	happen	occur
fator	factor
entorpecentes	narcotic
prova	test	evidence	proof
doze	twelve
altura	height
travar	hamper	connect	brace	impede	restrain	join
calibre	caliber	gauge	calibre
cruzar	cruise	cross
contemplar	behold	gaze	contemplate
carteira	purse	desk	driving license	wallet
gostar	enjoy	like
iniciar	start	initiate	begin
conclusão	conclusion
inicial	initial
sétima	seventh
derrubar	throw down	drop	tackle	knock down	tip
priorizar	prioritize
mostrou	display	show	exhibit
educação	education
prejuízo	injury	disadvantage
violência	violence
sigiloso	secret
resolver	solve	resolve	settle
parar	stop	cease	halt
eletrônico	electronic
deter	detain	deter	withhold
simbolizar	symbolize
canteiro	stone cutter	sculpton
afastar	deviate	ditch	stand back	avert	stray
vitimar	victimize
represo	repress	dam
mérito	merit
limpar	cleanse	clean
brilhar	shine
cercar	fence	corral	surround
imigrante	immigrant
arcebispo	archbishop
gestão	management
cumprimento	congratulation	greeting	fulfillment
exibição	exhibition
prosseguir	pursue	continue	proceed	carry on
comparação	comparison
checagem	checking
litoral	shore	coast
sorte	sort	luck	chance	destiny	fortune	fate
requerido	request	entail	require	demand
humano	human
momento	moment	instant
absurdo	absurd
postura	attitude	stance	posture
belo	beautiful	handsome
gol	goal
estelar	stellar
camisa	shirt
compreender	realize	understand	comprehend	comprise	include
dólar	dollar
botijão	compressed gas container	cylinder
autorizado	authorized
antes	before
coordenar	coordinate
arquibancada	rows of seats in a stadium	bleachers
progresso	progress
favela	slum	favela
inspiração	inspiration	breathing in
antecipou	anticipated
expor	expose	display	show
condado	authority of a count	county
centrada	centered	focused	centralized
assinalar	designate	brand	mark
enfermagem	nursing
renuncie	resign	renounce
semáforo	railway signal	semaphore	traffic light
climático	climatic
ficaram	stay	last	remain	endure
invasão	invasion
realizados	achieved	accomplished	realized
eliminatório	eliminatory
norma	norm	rule	precept
suspensão	hoisting	suspension
desocupação	lack of occupation	indolence
milhar	a thousand	chiliad
curva	curve	bend
vergonha	shame
bancário	bank clerk	teller	banking
esfera	sphere
sexto	sixth part	sixth
primeiro	first
estar	be
unidade	unit
significar	mean	signify
orgulhoso	vain	proud
carceragem	incarceration	imprisonment
União	union
pertencia	belong
aqui	here
religioso	devout	religious person	religious
túnel	underground passage	tunnel
bela	beautiful	belle
machucou	hurt	injure	wound
extraordinário	extraordinary
flutuar	fluctuate
oculto	occult	hidden
letra	word
charmoso	charming	graceful
evolução	evolution
usar	use	wear
competente	competent	capable
curso	course
circulação	circulation
comunista	communist
recorrer	search	scrutinize	apply for	appeal to	investigate
extremo	extreme	the end	utmost
prédio	building
inspeção	inspection
pró	for	pro	in favor of
pressionando	compress	press
paiol	bunker	barn	storehouse
retratar	portray	paint	abjure	retract
escritório	office	study
piores	worse	worst
nominal	not real	nominal
totalizar	totalize
fórum	forum
quantidade	amount	quantity
ocorresse	happen	occur
crescer	enlarge	grow	expand	develop
movido	moved	taken	caused
incapaz	incapable
habilidoso	skilled	dexterous	handy	skilful
solicitação	solicitation
telefonema	phone call
surgimento	outbreak	emerging	appearing
sofrer	endure	suffer	grieve
verdadeiro	real	true
domínio	dominion
empatar	tie
tampouco	neither	either
finta	feint	contribution	dodge
intermediário	intermediary
turno	turn	shift
aditamento	additament
conhecer	meet	be familiar with	know	get to know
norte	north
enriquecer	enrich
subterrâneo	subterranean
futuramente	futurely	in time to come
dirigir	direct	control	drive
presidente	president
chegar	arrive	come	closer	approach
deliberativo	deliberative
pênaltis	penalty
intermediária	intermediary
saber	knowledge	erudition	learning	know
interromper	interrupt
novamente	again
pertencer	belong
inimigo	enemy
demorar	lag	be late	linger	tarry	loiter
robustez	strength	lustiness	robustness
atravessar	traverse	cross
instituição	institution
obter	acquire	obtain	get	achieve	gain
cá	here
resgate	liberation	rescue	redemption
aquecimento	warming	heating
relógio	clock	watch
posicionar	position
atalho	obstruction	obstacle	bypath
infundado	unfounded
açúcar	sugar
trave	crossbar	beam	bar
sair	leave	go out	quit
efetivo	effective
causar	cause	induce	bring on
quarta	fourth
ansiedade	angst	anxiety	anguish
tampo	toilet seat cover	barrel top
queimar	burn
críticos	critic
pasta	paste
parente	relative	kinsman
balcão	counter	balcony
quarto	fourth	bedroom	quarter	room
valor	value
sentir	feel	experience
desabrigo	leave without shelter	unshelter
fraude	smuggling	cheating	fraud
aberto	open
superior	superior	excellent
dois	two
suicídio	suicide
de	of	from
tomou	seize	take
conjunto	joint	concerted	conjunct	set	suit	kit	combined
analisar	analyze	think	investigate
intensivo	intensive
do	of the
afetar	affect
comemoração	commemoration
metrô	subway	underground
estadual	state
destruição	destruction
atingir	reach	strike	hit
facilidade	facility
choque	surprise	shock
em	in
es	it is understandable that	conforms to	person	the intent is	such a pity	fools rush in where angels fear to tread	the rest is history	people are	being	it is evident that	the face is a mirror of the soul	the joke is that	the intention is	absence makes the heart go yonder	woman	the sky is the limit	be	this is the life	life is beautiful	is alarming	silence is golden	the fact is that	the flesh is weak	so	the sight of blood is shocking	to err is human	not actually the case	the responsibility lies with	when somebody is	wrinkles are beautiful	before light is coal	it is the same	supposing	the sad reality is that	the idea is	coexistence is difficult	the truth is that	be thankful that	it is clear that	experience is a plus	time is money	health is the most important thing	that is why	the eyes are the mirror of the soul	love is blind	since the world began	it is a shame that	the thing is that	you were given fair warning	in fact	as is necessary	the wise remain silent	that is to say	be for	it is certain that	attitude is everything	you were warned	man	that is all	that is the last straw	that is	serves as	health is the key	ignorance is the mother of imprudence	as is needed	it is for that reason that	anything goes	it is the custom	this is	experience is a rank in itself	be grateful that	it is customary	quite another story	the information provided is	the cure is worse than the disease	the thing is	it is true that	complies with	hypothetically
aí	there
detectar	detect
tentou	try	attempt	tempt
sanguessuga	leech	bloodsucker
normal	regular	normal	natural
capaz	competent	able	capable
situar	situate	place	locate
reduto	redoubt	temporary fortification
leste	east
tinha	had
água	water
ano	year
refletir	think	deflect	ponder	reflect
campanha	countryside
da	of the
liberar	liberate	discharge	settle
responsável	responsible
Presidente	president
continuar	continue
cifra	figure	cipher
apoiar	support	back
abertura	opening
congestionamento	congestion
verdade	truth
restaurante	restaurant
véspera	eve
recente	recent
poeira	dust
psicológico	psychologic	psychological
fornecer	provide	supply
passo	pace	gait	walk	step
multiplicação	multiplication
migração	migration
escapar	escape
separado	separate	apart
escolha	choice
classificou	classify	qualify
passe	permission	pass
metro	meter	meter stick
drible	dribble
cruzou	cruise	cross
as	the
ala	line	row
ar	air
começar	start	begin
reboque	streetwalker	tow truck	paster	act of towing
relatório	report	account
incêndio	conflagration	burning	fire
boato	rumour	rumor
histórico	historical	historic
distribuidor	distributor	distributer
sangrento	bleeding	description of rare meat	bloody
imobiliário	real estate
palavra	word
no	in the
terceiro	third
suspeito	suspicious	suspect	suspected
muito	many	plenty	lot	much
espontâneo	spontaneous
inclusive	inclusive	including
sentença	judgment	verdict	sentence
guerrilha	guerrilla
lucrar	profit	benefit from	gain
regime	diet	regimen	regime	administration
identificar	identify
texto	text
triplicar	multiply by three	triple	treble	triplicate
separar	separate	detach	part
fugir	flee	elope	run away
dono	landlord	owner	proprietor
morder	hurt	instigate	bite	stimulate	torment
arrancado	jerked	jolted
trabalho	work
mãe	mother	mom
lá	there	la
fusão	amalgam	merger	fusion
mão	hand
ginásio	gymnasium	gym
pessimismo	pessimism
noroeste	northwest
petrolífera	bearing petroleum	petroliferous
presidenciável	eligible to be president
maioria	majority
governo	government
enchente	flood
plano	plan
condição	condition
cabeceira	headrest	headboard	cushion
amanhã	tomorrow
identificação	identification
cessar	cede	surrender
moto	motorcycle	motto
desfecho	conclusion	outcome
me	me
marítimo	relating to the sea	maritime
diplomacia	diplomacy
atleta	athlete
símbolo	symbol
seção	division	slice	section
na	in the
já	already	ever	yet
item	item
crer	believe
dormir	sleep
controlar	control
chamar	call	name	convoke	shout
confirmação	confirmation
balanço	swinging	audit	oscillation
minúcia	detail	nicety	minutia
dever	obligation	ought to	homework	duty	task	should	must	owe
conferência	lecture	convention	conference	talk
kg	kg
economista	economist
jogadas	scheme	plot
governar	govern	rule	command
mora	respite	delay
desenvolvimento	progress	development	growth
moro	inhabit	live
errar	err	miss
ênfase	emphasis
sudoeste	south west
quarteto	quartet
evangélico	evangelic
sucessor	follower	successor
leve	light
pressionar	compress	press
amplo	spacious	ample	roomy	wide
km	km
há	there are	there is
curar	cure
argumentar	argue	dispute
milícia	militia
relevante	significant	important	relevant
la	there	la
entendimento	understanding
agora	now	at this moment
cirurgia	surgery
artista	artist
vendedor	clerk	vendor	seller
possibilitar	make possible	enable
Ambiente	environment	atmosphere
dourado	golden
têxtil	woven	textile
monte	heap	pile	accumulation	portion
ameaçar	menace	threaten
estender	extend	spread
mês	month
prefeitura	city hall
protelar	delay	put off
identidade	identity	identicalness
lavar	wash
agenda	agenda	schedule	diary	organizer
ir	go
inovador	innovating	innovative
composto	composed	compound	made of	composition
natação	swimming
possível	possible
transformador	transforming	transformer
necessidade	necessity
tráfico	traffic	trade	shady deal
gado	stock	herd	cattle	live stock
dependente	dependent
tamanho	scale	dimension	size
cadeia	prison	chain	strand	string	jail
mandou	order	command
local	site	local	place	venue
recomendado	recommended
guerrilheiro	guerrilla
trimestral	trimestrial	every three months
cobrar	charge	bill
devolver	give back	refund	return
segurança	safety	security
avô	grandfather
aliança	alliance	wedding ring
atrasado	delayed
colar	cheat	stick	paste	glue	tape	necklace
sonoro	loud	resonant	sonorous
isolados	isolated
diário	daily
terços	middle part of a ship	a third part of anything
só	just	solitary	only	lonely
placa	sign	tag	plate	plaque
cumprir	accomplish	fulfill	carry out	comply	abide	perform
asfalto	tarmac	asphalt
piscina	swimming pool
juízo	proposition of something believed or asserted	capacity for judging
Pompeo	be pompous	show off	act pompously	flaunt
humanitário	humanitarian
festivo	festive	merry
clima	ambience	atmosphere	climate
através	through	across
estágio	internship	stage
federação	federation
anual	annual
emergência	emergency	emergence
fisionomia	physiognomy
perceber	realize	perceive	notice
evento	happening	event	occurrence
citar	cite	quote	summon
funcionamento	functioning
socorro	help	assistance	aid
surgir	arise	appear	emerge
decepcionar	disappointment
cruzamento	crossing
sanguessugas	leech	bloodsucker
conjunção	conjunction
sacudir	jerk	jar	jolt	shake	quake
revitalização	revitalization
supermercado	supermarket
potável	drinkable	potable
projeto	project	plan
refúgio	refuge	retreat	shelter
matriz	matrix	womb
colaboração	collaboration
criticar	criticize	judge	review
incompatível	incompatible
objetividade	objectivity
fabrica	plant	factory
um	an
un	get in trouble	reserve a seat	make a mountain out of a molehill	dance like a duck	write down a phone number	carry a problem around	underside of a vehicle	assign a social security number	make use of a space	in less than a year	before the authorities	in front of some guy	commit oneself	skip a grade	approve a plan	drag a load	prepare a catalog	years in business	feeling like a	move up	make trouble	facing a guy	make a commitment	set a salary	reserve a spot	score a triple	give a discount	by the side of	take aim at someone	take on a new business	mess things up	diary entries	fork in the river	near to	set up a stage	get a little closer	really want to	pass through a place	organize a catalog	enforce punishment	go along on a trip	put out a cigarette	receive a promotion	produce a commercial deficit	punch hard	mount an awning	cancel a test	chassis	take care of a payment	assign a salary	before some guy	responsibility for a crime	dress a corpse	go here and there	ironclad contract	sign a tax into law	produce a balance	to one side	disallow the goal	give a hard punch	contract addendum	be game for anything	put a place aside	drill through a layer of soil	turn off a cell phone	achieve something	use a space	set up a canopy	take care of a patient	file a case	allocate a payment	a good or better job	make a mess	sign up for a trip	age of a car	on the side	friend of a friend	point a gun	before the year is up	a tempest in a teapot	picture frame	move to one side	go for a different style	show up for a minute	use some free time	beneath a canopy of stars	assume a post	work on a jigsaw puzzle	alongside	cargo hold	project background	trapped in a dream	be forgetful	car frame	pull out a hair	deliver a blow	join an excursion	a promotion	file a procedure	take office	want very much to	considering a great opportunity	pass an exam	induce labor induce early childbirth	rely on an outline	make the most of a bit of free time	attend to a patient	very close to	approve a project	treasure a memory	approve a tax	have a bad memory	cargo compartment	assign a number	caught up in a dream	apply a discount	bank on a concept	learn a ton	give a test	point a gun at someone	bite off a mouthful	hit a triple	set up a tent	accomplish something	apostille a birth certificate	in front of an audience	take a position	contribute a new point of view	get a phone number	just one step away from	an	make note of a phone number	make text appear	learn a whole lot
alimentação	nourishment	alimentation	feeding
acima	above
para	to	for
posicionamento	position	positioning
semanal	weekly
tranqüilamente	calmly	quietly
nervoso	nervous
função	function
pé	foot
sócio	partner
abandonar	abandon
envolvimento	involvement
cooperação	cooperation
classificar	classify	qualify
deflagrar	explode	deflagrate	burn
começou	start	begin
caminhar	walk	hike
Café	coffee
indevido	undue	unjustified
povoado	village	settlement
ocasião	occasion
desencadear	unleash	unchain
gabinete	office	cabinet
exigir	demand
adolescente	adolescent
acidente	accident
ambiente	environment	atmosphere
se	if	self	whether
Quase	almost	nearly
invalidar	invalidate
discursar	make a speech
produzir	produce
natural	native	natural	character
iniciavam	start	initiate	begin
interferência	interference
opor	prevent	oppose
notadamente	notably
certeza	sureness	certainty
defensores	defender
roupa	clothes	clothing	garment	outfit
simultâneo	synchronic	simultaneous
competição	competition
lento	deliberate	slow
colocado	collocated	set
novidade	news	rule	precept
sofrimento	suffering
que	that	what
telão	big screen
indício	trace	indication	clue	symptom
viatura	vehicle	means of transport
emenda	amendment	correction
reter	hold back	detain	retain	keep
lógico	logical
executar	execute	carry out	perform
completar	complement	conclude	complete
pressupor	presuppose	assume
foto	picture	photo
desastre	disaster
torrencial	torrential
declarar	declare
pago	payment	remuneration	wages
test	test	vocational orientation test
retirado	solitary	secluded	retired
acionar	put in action
forte	strong
drama	play
países	nation	country
explicar	explain
exortar	exhort
circular	move in a circle	surround	circulate
tese	thesis
enfrentar	deal	face	play against	confront
imóvel	motionless	steadfast	firm	still	quiet
cobrir	cover	veil	coat
ferreira	blacksmith	smith	ironmonger
havia	there to be
requisitar	solicit	request	requisition	demand
impulsionar	impel
recompor	recompose	give a new form to	renew
subsídios	subsidy
pesado	heavy
foro	forum	tribunal	court
delta	delta
combustível	combustible	fuel
exame	examination	medical	quiz
assinar	sign	underwrite	subscribe
marcado	distinctive	drug dealer	marked
liderança	leadership
assessor	advisor	consultant	counselor
conhecimento	bill of lading	knowledge	understanding
problema	trouble	matter	problem
cita	cite	quote	summon
adulto	adult
loja	shop	store
teto	roof	ceiling
roubo	theft	robbery
proceder	conduct	proceed	procedure
costa	shore	back	coast
agrícola	agricultural
ensaiar	practice	rehearse
distribuição	distribution
acostumar	be used to	accustom	habituate
aproximar	near	approximate	come near
produto	product
nova	news	novelty
isso	that	this
poderoso	powerful
porquê	cause	reason
hóquei	hockey
novo	new
compromisso	obligation	commitment	liability	pledge	promise	engagement
descoberto	discovered
reclamação	object	complaint	demand
vencedora	victor	winner
conformar	conform	shape
nove	nine
fora	except	flop	save	outside	out	blunder
reiterar	reiterate	repeat
haver	there to be
Minha	mine	my
evacuar	evacuate	empty
décimo	tenth
ganho	earnings	lucre	profit	gain
convencer	convince
vazamento	leakage	leak
cálculo	calculation	figure	computation	reckoning	mathematics
psicólogo	psychologist
abadia	abbey
contido	restrained
essência	essence
feijoada	dish of beans and pork
show	show
treinar	practice	train
fabricante	manufacturer	industrialist
margem	bank	margin
desgaste	consuming	erosion	abrasion	wearing	wastage
mandado	order	mandate	writ
militar	soldier	military
fraudulento	fraudulent
fornecimento	furnishing	supplying
declaradas	declared
distanciamento	detachment	separation
obstrução	obstruction	impediment
absorção	absorption
tendência	trend	tendency	inclination	disposition
vigor	vigor	vigour
imagem	image
ativo	busy	active	vigorous	energetic
legislação	legislation
trilho	harrow	trail	track	thrasher
depender	count on	depend
duvidosa	doubtful
gravar	record	engrave	tape	carve
percentual	percentage
rodovia	highway
encobrir	cover	occult	disguise	conceal
assomar	mount	emerge
agente	agent
mural	mural	relating to a wall
além	hereafter	the other world	eternity	beyond
fome	hunger
forme	form
perder	lose	miss
beneficiar	benefit	protect
tomar	take	seize
ato	deed	action	act
cessar-fogo	cease fire
enganar	deceive	trick	fool
execução	accomplishment	execution
qualidade	quality
forma	form	shape
expansão	expansion
decidir	decide	resolve	settle
comércio	trade	commerce
intervenção	intervention
realizado	achieved	accomplished	realized
restante	remainder	rest	residue
distinguir	distinguish
chance	opportunity	chance
constituição	constitution
desejo	desire	wish	will	hope
ampliação	amplification	increase
destruir	destroy
aguardar	expect	await	hold	wait
tão	that	such	so much	so	as
intenção	intention
incentivo	encouragement	incentive	incitement
etanol	ethanol
recurso	appeal	resource
ferir	strike	injure	wound
prato	dish	plate
fez	did
subir	climb	raise	rise	hike
conter	repress	contain	refrain	comprise	comprehend
viver	live
palma	victory	palm of the hand	palm leaf
desconhecido	anonymous	unknown
multa	ticket	fine
espaços	space
inflamação	inflammation
triangulação	triangulation
facção	faction
município	municipality	city council
defender	defend
importância	importance
cópia	imitation	copy	backup
prata	silver
cheque	check	cheque
pneu	tyre	tire
básico	basic
partido	political organization	party
denunciar	denounce
emprego	usage	job
recesso	recess
grande	big
ponte	bridge
ponto	point	full stop	stitch	period	dot
precipitar	precipitate
preventivo	preventive
acusar	accuse
agressor	aggressor
tripulante	member of the crew	sailor
recentes	recent
solar	sole a shoe	solar	manor house
radioativo	radioactive
basquete	basketball
servidor	attendant	server	domestic
mínimo	minimum	least	minimal
partida	departure	match	game
façanha	achievement	feat	exploit
digestão	digestion
mover	put in motion	cause	persuade	move	advance
aldeia	village
pisar	step on	tread on
império	imperium	empire
capital	capital
negociar	negotiate	do business
abordar	approach	tackle	board
esteira	wake	treadmill	carousel	conveyor belt
comercial	add	commercial
ilegalidade	illegality
prisioneiro	prisoner
faz	does	makes
afirmação	affirmation
competir	compete
socorrer	succour	help	assist	aid
tramita	course	path	way
protocolo	protocol
eleito	elected
conhecido	notorious	acquaintance	known
lesar	bruise	damage	injure
assessoria	consideration	advisement
metálico	metallic
puxar	pull
tocar	ring	touch	play
hospitalizar	hospitalize
declarada	declared
distribuir	distribute
melhorou	ameliorate	improve	recover	get better
borracha	eraser	rubber
conquistar	vanquish	defeat	accomplish	conquer	achieve
conquistas	conquest	accomplishment	achievement	conquering
rotina	routine
obsceno	obscene
Associação	society	association
oferecer	offer
externo	exterior	external	outside
avaliar	evaluate	rate	assess	estimate
detento	prisoner
contrário	reverse	unlike	opposite	contrary	on the contrary
poupado	saved
pacto	compact	pact	agreement
remanescente	remainder	remnant	surplus
revelar	reveal	disclose	develop
rolo	roll	reel
autorizar	authorize
equipes	team
tectônico	tectonic
homenagem	honor	homage	tribute
atestar	certify	attest
arregaçar	turn up	tuck up	pin up
marca	brand	mark
oeste	west
freqüentes	often	frequent
garantia	guaranty	guarantee	warranty
destino	destiny	destination	fate
reconsiderar	reconsider	give a second thought
garantir	warrant	guarantee	ensure
atacante	aggressor	assailant
fonte	source	fountain
igual	peer	equal	same	like	alike
preparatório	preparatory
redes	net	network
cancelamento	cancellation
nacionalidade	nationality
roto	ratty	tattered	ragamuffin	shabby
dirigente	director
vagão	railway car	railway carriage	wagon
diverso	different	diverse
vantagem	advantage
armazenagem	warehousing	storing
pescador	fisherman
plataforma	platform
social	social
faixa	band	strip	stripe
palco	stage
magnífico	magnificent
adicional	additional
desarmamento	disarmament
saltar	leap	jump
ramo	nosegay	bough	twig	branch	offshoot
desaparecer	disappear	vanish
saudar	hail	salute	greet
reação	reaction
aliás	as a matter of fact	by the way	incidentally
fugitivo	fugitive	escapee
jurídico	legal	judicial	juridical	forensic
cenário	setting	view	scenery	landscape
relação	listing	relation
nota	bill	check	grade	note
quinto	fifth	fifth part	hell	barrel
Barão	baron
extraditado	one who has been extradited
profundidade	profundity	depth
descobrir	uncover	discover	find
natureza	nature
centenas	group of a hundred	a hundred
esperado	expected
protesto	protest
forçar	force
condomínio	condominium	joint ownership
médio	halfback	mean	medium
predatório	predatory
colecionar	collect
inocência	innocence
piloto	pilot
acordo	deal	agreement	understanding
úlcera	open sore	ulcer
assessorar	help	advise	assist
orientar	direct	mentor	orient	orientate
apresente	present	introduce
esboço	sketch	outline
confusão	disorder	mess	confusion
favorecer	favor	protect
complicação	trouble	complication
contar	relate	count	narrate	report	tell
palha	straw
aumentou	raise	rise	increase
recusar	refuse	disclaim	deny
oportunidade	opportunity
raro	rare	thin	scarce
observação	observation
adiantar	progress	be worth doing sthg	move on	advance
coletar	gather	collect
previstos	expected	foreseen
ponta	point	tip	end
desarticular	dislocate	disarticulate
exposto	exposed
precedente	precedent
nome	fame	title	name	reputation
comum	ordinary	common	average
modalidade	modality
agradar	please	appeal	be agreeable
votar	elect	poll	ballot	vote
separadamente	separately
expedir	ship	issue	dispatch
paralisar	paralyze
chover	rain
cabecear	beckon	nod	doze
jogar	play
comedir	moderate	restrain
retirar	withdraw	draw back
unânime	unanimous
proteção	protection
suspenso	hanging	interrupted	suspended
visitar	visit
nono	ninth
exército	armed forces	army	troops
marcar	imprint	score	mark
cereal	grain	cereal
trouxe	brought
entregues	delivered
podiam	might	may	can
dança	dance
efeito	effect
analisado	analyzed
temperatura	temperature
ouro	gold
perigoso	dangerous
emboscada	ambush
limitado	limited
conquistaram	vanquish	defeat	accomplish	conquer	achieve
baixar	lower	ebb	download
redor	environs	circuit	circle
feito	deed	done
formalizar	formalize
encontrar	meet	stumble upon	find	come across
espetacular	spectacular
estrada	road
maré	tide
população	population
suprimento	subsidy	supply	loan
efetuar	accomplish	perform
sorrir	smile
personagem	personage	character
procedente	proceeding	coming from
soltar	release
arquivar	register	file	shelve
julgamento	court session	trial
atenuar	attenuate	weaken
opositor	opposing	opponent	candidate	antagonist
resistir	resist	oppose
brusco	brusque	harsh	rough
assegurar	insure	affirm	guarantee	assert	assure	ensure
índice	hand	index	needle	pointer	table of contents
fabricação	fabrication
golpe	stroke	blow
elevado	elevated
triste	sad
mata	wood	jungle	forest
jovem	teenager	youth	young
idéia	idea
famoso	famous	renowned
agilizar	make agile
cardiologista	cardiologist
empregado	employee
útil	practical	constructive	useful
estrago	harm	damage	injury
melhorar	ameliorate	improve	recover	get better
foguete	firework	rocket
chama	blaze	act of calling	flame
rápido	quick	rapids	fast
menino	boy
aprofundar	deepen
tradicional	traditional	customary
desenvolvido	developed
consulta	consulting	consultancy	appointment
observar	observe	watch	view
jogaram	play
proposto	proposed
valer	value	worth
agricultura	agriculture
verificação	examination	check	verification	inspection
farra	binge	spree	bender
oficializar	officialize
prateleira	shelf
limitar	limit	restrict
pronto	done	finished	ready
retorno	coming back	callback	return
era	were	age	era	was
saque	sack	serve	draft	spoil	service	pillage
administrativo	administrative
recentemente	recently
telhado	roof	tiling
depositar	deposit
tempestade	rainstorm	storm
abusados	abused
vocação	vocation	talent	calling	inclination	vein
movimento	movement
sondagem	sounding	drilling	exploration
segundo	second	according
Pouco	little	few
horrorizar	horrify
acumular	accumulate
ânimo	animation	soul	vitality
arranha-céus	skyscraper
cartaz	placard	billboard	poster
ferro	iron
confissão	confession	act of confessing
residente	resident
desdobramento	unrolling	unfolding
desbloqueio	raising of a blockade
chegada	arrival
depoimento	declaration	deposition	testimony	affidavit
semelhante	resembling	fellow creature	like	similar
marcou	imprint	score	mark
litro	litre	liter
ele	he
elite	elite
tentar	try	attempt	tempt
respectivos	respective	concerning	relating to
laranja	orange
sonegação	theft	fraud	unlawful concealment
telescópio	spyglass	telescope
celeste	heavenly	celestial	ethereal
irregularidade	irregularity
ontem	yesterday
furacão	hurricane
alimentar	nourish	feed
avião	plane	airplane
susto	scare	fright	shock
propaganda	propaganda
financeiro	financial
sereno	calm	tranquil	serene
mina	source of richness	mine
libro	tome	book of complaints	a ledger	textbook	put up	open book	fight	logbook	issue	a white paper	grade book	report card	draw	reader	mark book	hardcover book	write out	be free	be an open book	book	hardback	restore a book	bedside book
golfo	gulf
prazo	term	deadline
alterado	altered	changed
desaceleração	deceleration
tornar	turn	return
nível	level	plane	level surface
vitória	victory
cravar	thrust in	drive in
desconforto	discomfort
resto	remainder	remnant	rest
portuário	of or relating to a port	dock worker
medalhar	medal
desmentir	deny
assassinato	murder	assassination
idoso	elder	old	senior	aged
crescimento	increase	growth
representar	impersonate	play	personate	perform	act	represent
errante	erring
aceleração	acceleration
esposo	husband
desconhecer	not know	ignore
dúzia	dozen
retaliar	retaliate	take revenge
implicar	implicate	imply	taunt
tribunal	court of law	judgment	jurisdiction
frisar	be similar to	curl hair
moderno	modern
licitação	licitation	public tender	bid
ação	action
melhoria	melioration	improvement
título	title	name	designation	label
recolher	collect
receber	receive
restaurar	restore
comer	eat
mentira	lie
Antes	before
helicóptero	helicopter
cuidado	watch out	care
regimento	regiment	government	regime	administration
lançar	throw	release
vela	candle
aprovar	approve	agree
acolher	shelter	house	welcome	receive	lodge
acusado	accused
escala	scale	stop over
corrida	racing	run	race
veio	axle	arbor	spindle	shaft
controle	control
política	politics	policy
decorrer	elapse	derive	happen	occur
coronel	colonel
corrente	draft	stream	chain	current	draught	flow
admissível	admissible
disfunção	dysfunction
político	politician
estabelecer	set	establish	settle
referente	referring	regarding
riqueza	opulence	riches	wealth	wealthiness	abundance
chegado	near	proximate	arrived
governamental	governmental
aflição	affliction
tenso	tense	stretched
renúncia	resignation	renunciation
estado	state
sindicância	syndication	investigation
costume	custom
diminuir	diminish	lower	lessen	decrease	reduce
fundamental	fundamental
total	total	entire
menor	minor	little	younger	smaller	lesser
menos	less
goleada	heavy defeat
provar	prove	test	taste	try
incursão	raid	incursion
onde	where
hegemonia	hegemony
beijar	kiss
entregar	deliver	denounce	hand in	betray
história	history	story
carrinho	trolley	buggy
receio	terror	dread	fear
procuradoria	procuracy
painel	panel	frame	pane
apurar	select	improve	choose
atmosfera	atmosphere
prestar	be useful	render
optou	choose	opt
estilo	style
padre	priest
corresponderam	correspond
fita	flick	band	ribbon	tape
ameaça	threat
transcrição	transcription
onda	wave
reinício	recommencement	new beginning
comparar	compare
privadas	toilet
desviar	diverge
melhor	better
câmera	camera
direção	direction	driving	management
trazer	get	bring
flagrar	inflame	glow	burn
decoro	decorum	decency
machucar	hurt	injure	wound
converter	convert
ombro	shoulder
filme	film	movie
sonegado	concealed	hidden	unpaid
Segundo	second	according
aquisição	acquisition	buy	takeover	purchase	procurement
restituição	restitution
anão	dwarf
professores	professor	teacher
auditor	auditor
frio	cold
diferente	different
enorme	enormous
chocar	shock	stun	hatch	clash	bump
canário	canary
vasto	colossal	vast
estatístico	statistician
isolada	isolated
fornecedor	supplier
turístico	touristic
desconto	discount
sociedade	society
suscetível	susceptible
acerto	judgment	hit
grave	grave	deep
revirar	turn inside out	turn over	turn upside down
realização	accomplishment	achievement	realization
sala	hall	chamber	room
tentativo	experimental	trial
são	are	sound	healthy	saint
fixo	firm	fixed
transmitir	transmit
caneco	ewer	jug
validade	validity
prerrogativa	prerogative
direita	right
engenharia	engineering
incluiu	include
desaparecido	disappeared
incluir	include
oitava	octave	group of eight
aceitar	accept
unido	united	joined	allied
registrar	register	record	list	write down
pergunta	interrogation	inquiry	question
perícia	expertise
direito	properly	right
enfrentamento	confrontation
usina	plant	mill	workshop	factory	works
distante	distant
jóia	jewel	gem
golpear	knock	beat	strike
diretoria	direction	board of directors	management	administration
luxo	luxury	splendor
preço	price
dominar	dominate
integrante	component	constituent
celebrar	celebrated
centrar	center	fix in center
confidencial	classified	confidential	private
estratégia	stratagem	strategy
central	central
gritar	scream	yell	shout
indicação	indication
distrito	district
substituição	substitution
planejar	plan
deslizar	glide	slip	slide
representante	representative
campeão	champion
surpreender	marvel	astonish	surprise
feriado	holiday
tratamento	treatment
passado	latter	last	bygone	gone	past
delegado	delegate
sobreviver	survive
ministerial	ministerial
caixa	register	box	cashier
ficar	stay	last	remain	endure
espaço	space
estabilização	stabilization
conta	calculation	numeration	count	bill	check	account	sum	reckoning
oscilação	oscillation
polêmico	contoversial
oposto	opposite	contrary
comida	food	meal
amargar	make bitter
colisão	crash	impact	collision
gosto	taste
departamento	department
desvio	detour	diversion	bypass	swerve	veering
deslizamento	sliding	slipping
similar	analogous	similar
banco	bank
infração	infraction
vilarejo	village
fuzil	rifle	flintlock	gun
contabilizar	do bookkeeping	do accounting
primeiro-ministro	prime minister
massa	mass	dough	mortar
reclamar	complain	nag
elétrico	electric
consecutivo	consecutive
assunto	matter	subject
molde	norm	pattern	mould
camarote	cabin on ship	box
máxima	maxim	precept
ilegal	illegal
duro	hard
extorsão	extortion
divulgação	publicizing
comprar	buy	purchase
receita	recipe	prescription	income	revenue
alterar	change	modify	alter
capacidade	capacity
sobre	over	about	above
acrescentar	add
assembléia	assembly
nação	nationality	nation
transtornado	perplexed	confused	disturbed
colher	spoon	pick	harvest
derrotar	defeat
máximo	highest	maximum	greatest	best
defeito	flaw	deficiency	defect	imperfection	fault
nascido	born
optar	choose	opt
insuficiente	insufficient
propenso	propense	inclined
arma	weapon	arm	gun
localizados	localized
filho	son
maior	bigger	adult	major
alertar	alert
examinar	examine
pavilhão	canopy	pavilion	banner
prioridade	priority
apreendido	arrest	apprehend
interessar	interest	concern
tentáculos	tentacle
proprietário	owner
conduzir	guide	conduct	lead
resolução	resolution
respeito	respect
técnico	technician	coach
atentar	attempt	venture	try
expressar	depict	show	express
terça	the third
diretor	principal	head	director
servir	serve	wait on	perform duties
abafado	sultry	oppressed	muffled	stuffy
vivência	life	being	existence
portador	carrier	porter
humilhante	humiliative	humiliating
qualificar	appreciate	qualify	estimate
fico	stay	last	remain	endure
divulgar	divulge	disclose	publicize	publish
fiança	bond	surety	pledge	guarantee
árvore	tree
neve	snow
arte	craft	skill	art
pensamento	thought
estatal	state
bombeiro	fireman	plumber
enfraquecido	weakened
desabafar	reveal	uncover
genocídio	genocide
retornar	give back	return	come back
Não	not	no
chuva	rain
disse	first and third person preterit form of dizer
impacto	hit	shock	impact
vencido	overcome	vanquished	subdued
dançar	dance
boletim	bulletin
conseqüentemente	consequently
faculdade	college	faculty
ceder	concede	submit	cede	yield	remit	comply	give in	back away
bastar	suffice
terrível	frightening	terrible	grisly	horrible
nunca	never
explosivo	explosive
promulgar	promulgate
transferir	transmit	transfer	communicate
devastador	devastating
motor	engine	motor
chute	kick	guess
repercutir	throw back	report	reverberate	deflect	recoil
breve	breve	brief
Rio	river
vontade	desire	wish	will
hospedar	house	lodge
repasse	pass again	recall	drench	saturate
permanente	permanent
livrar	liberate	release
penal	penal
lotar	distribute	allot
familiar	familiar	familial	relative	kinsman
edição	editing	issue
atrasar	defer	impede	lose time	retard	hinder	delay
terço	middle part of a ship	a third part of anything
terreno	site	terrain	ground	soil
solicitou	beg	solicit	request	ask
tocou	ring	touch	play
candidato	candidate
paradas	stop	parade	halt
azul	blue
determinar	determine
legenda	legend	subtitle	caption
modificar	modify
acordado	awake
eleitor	voter
começo	commencement	beginning
disputa	dispute	contest
chão	floor	ground	earth
festa	party
bastante	sufficient	satisfactorily	a lot	plenty	enough	pretty
reforma	reform	renovation	reformation
definir	define
anunciar	announce
contraproposta	counterproposal
Reportagem	newspaper report	class of reporters generally
goleiro	goalkeeper
negar	negate	deny	disavow
molhado	wet
lavagem	wash	act of washing
pintura	painting
acalmar	calm	pacify
assistir	help	attend	watch	assist	aid	be present
articular	enunciate	link	join	pronounce
luta	fight
revés	reverse	opposite side	backside
aluno	pupil
recolhimento	refuge	retirement	collecting	privacy	gathering
animal	animal
utilizar	use	utilize
convidar	invite
área	field	area	scope	yard	range	inner	court
embaixador	ambassador
colocação	setting	collocation	emplacement
cunhar	stamp	mint	emboss
bateria	battery	drum
apagar	extinguish	damp	erase	delete	quench
olé	ole
via	via	way
detonar	detonate
motorista	motorist
foi	went
reabrir	reopen
frente	front
fila	queue	line	row
vir	come
omissão	omission	neglect
introduzir	introduce
miliciano	militiaman	pertaining to a militia
excesso	remainder	excess	redundancy
alegando	allege
buraco	hole
discurso	speech
safena	saphena
mudar	change
cortar	clip	slice	cut	chop
rádio	radium	radio	radius
afastado	distant	remote
vinda	coming	arrival
velho	old
época	time	season	epoch	era
reverter	invert	revert	return	go back
isenção	act of exempting	exemption
criar	breed	raise	nurture	make	create
fortalecer	fortify	strengthen
pouco	little	few
evitar	avoid
cargo	office	charge	post	duty	task	job	situation	function
pauta	roll	staff	guidelines	list
ausência	absence
atual	present	going	current
criança	child	youngster	kid
aposentar	retire
subestimar	underrate	underestimate
oscilar	oscillate
carga	burden	freight	load	cargo
cuidar	take care of
suspender	suspend	hoist	hang
cofres	safe	strongbox	money box
velocidade	fastness	speed	velocity
fazenda	farm
industrial	industrial
lugar	place
probatório	probationary
dominou	dominate
superar	overcome	surmount
colocou	put	set	place
consumir	use	devour	consume
convicto	convict
freqüência	frequency
ajustado	settled	adjusted
clássico	classical
desembolsar	disburse	expend
pacífico	calm	tranquil	peaceable
criatura	creature
procedimento	proceeding	procedure
simular	simulate	pretend	fake
irritação	irritation
cortado	cut
fino	slim	fine
tiroteio	firing	gunfight	shooting
global	global
cancelada	canceled
cósmico	cosmic
senhor	sir	mister
droga	drug
apito	whistle
sessão	session
considerar	think	consider
destaque	distinction	prominence	highlight	eminence
cancelado	canceled
finalmente	finally
exaltar	praise	glorify	exalt
abalo	commotion
pensão	allowance	alimony	pension
gente	folk	people
encontro	meeting	collision	impact	shock
sindicalista	union member	syndicalist	trade unionist	labor unionist
explosão	explosion
lista	schedule	list
fim	end
fazer	do	make
aluguel	rent
gerador	generator
prazer	pleasure
minuta	minute	draft of a document
restavam	be left over	survive	remain	rest
serviço	service	supply	act of serving
rico	rich	wealthy
tranqüilidade	calmness	tranquility	quiet
principais	principal	chief	main
influência	influence
voz	voice
Apenas	just	only	merely
padrão	standard	pattern
participarem	communicate	participate
mistério	mystery
dissidente	dissident
dizer	say	tell	saying
atletismo	athleticism
estudantil	pertaining to a student
braço	brace	arm
tocha	torch	stump	firebrand
ângulo	angle
duelar	referring to a duel	duel	dueling
linda	gorgeous	beautiful	pretty
silêncio	noiselessness	silence	stillness
vaiou	boo	hiss	hoot
parecer	appear	opinion	seem
dentro	inside	indoors	within
time	team
ajeitou	arrange
aces	alternating current
aplaudir	applaud
bombardeio	bombardment
lindo	beautiful	handsome	pretty
discutir	argue	discuss
comentar	comment
saguão	lobby
adequado	adequate
vender	sell
manipular	manipulate
aula	lesson	class
parada	stop	parade	halt
informação	information
comercialização	commercialization
tolerável	tolerable
prorrogar	defer	postpone
protecionismo	protectionism
participante	participating	participant
conversar	converse	chat	talk
vez	turn	time
surpresa	amazement	astonishment	surprise
então	then
surpreso	amazed	astounded	surprised
ver	look	see
tributário	contributing	tributary
eletricidade	electricity
força	vigor	strength	power	force	energy
curvar	curve
conflito	flight	discussion	conflict	war
movimentados	active	busy	restless
escutar	hear	listen
terminar	finish	conclude	terminate
tripulantes	member of the crew	sailor
imposto	tax
amistoso	friendly	neighborly
troco	small coin	small change
prender	tie	fasten
instrução	instruction
urgente	urgent
racionamento	ration	rationing
base	foot	base
devoto	devout
voltou	return	come back
cultivo	cultivation
prometer	promise
ímpeto	impetus
terminal	final	terminal	ultimate
fato	fact
lidar	deal
Vai	go
firme	stout	robust	strong	durable
protestar	protest
desenvolver	progress	develop	advance
vital	vital
conquista	conquest	accomplishment	achievement 	conquering
definitivo	definitive
fase	phase
excepcional	exceptional
lição	lesson
das	of the
revezamento	relay	alternation	reciprocation
motivo	motive	purpose
dar	give	donate	bestow
manobra	military exercise	maneuver
Internacional	international
disputar	dispute
malha	knitted fabric	mesh
montanhoso	mountainous
alongamento	lengthening	stretching
exercício	practice	exercise	workout
extradição	extradition
partir	leave	depart	split
encomendar	order	recommend
secreto	occult	hidden	secret	private
evitando	avoid
alma	soul
desbaratar	waste	squander
estabelecimento	establishment
matiz	hue	nuance	tint
relator	reporter	narrator	relater
dívida	debt
totalmente	totally	entirely
dentre	among	amongst
estilhaço	chip	scrap	fragment
assalariar	engage	bribe	employ
resposta	response	answer	reply
Transporte	transport	transportation
desmaiar	faint
planemos	plane	glide
patrimônio	patrimony	inheritance	birthright	heritage
hora	hour
retardar	slow down	postpone	prolong	retard	delay
ultrapassagem	overtaking	surpassingness
implante	implant
aprovação	agreement	approval
companhia	companion	company
atinge	reach	strike	hit
remanejar	transfer	rehandle	redistribute
jejum	abstinence	fasting	fast
jornal	newspaper
alcançar	reach	achieve
matou	slaughter	assassinate	butcher	kill
produtivo	productive
carro	car
hoje	today
eleição	election	polling
atrasos	lag	retardation	delay
copular	copulate
processo	process
atendimento	attendance	customer service	attending
ônus	charge	onus	burden
controlado	controlled
inundação	inundation	flood	overflow
subido	lofty	high	exalted
vizinho	neighbor
prestação	installment
virtude	virtue
tonelada	tonne	ton
maneira	means	way	manner
pessoal	personal	staff	personnel
colocar	put	set	place
perito	expert	technician	specialist
acertar	nail	strike	hit	adjust	set right	regulate
auto	deed	document	act	writ
pessoas	folk	people
privado	private
acompanhado	accompanied
responsabilidade	responsibility
visibilidade	visibility
carta	letter
necessitar	necessitate
alerta	alert
disposto	ordered	eager	willing	ready	disposed
anacrônico	anachronistic
ministro	minister
conceder	concede	grant
unificação	unity	unification
chutou	kick	guess	despise
sandália	sandal
indenização	indemnity	indemnification
responder	respond	answer	reply
motim	insurrection	rebellion	mutiny
veracidade	veracity	truthfulness
irmão	brother
espécie	sort	species	specie	kind
narcotráfico	drug trafficking
folha	leaf	sheet
promover	promote
queda	drop	waterfall	fall
inflação	inflation
intenso	intensive	intense
linha	line
sensatez	prudence	wisdom	sensibleness
cometer	perpetrate	commit
monumental	monumental
abastecimento	supply	provision
realizar	accomplish	carry out	achieve	perform
esporte	sport
garçom	server	waiter
paradeiro	stopping place
saneamento	sanitation
alcoólico	alcoholic
intransitável	impassable
covarde	coward
possuir	possess	own
cofre	safe	strongbox	money box
invencibilidade	invincibility	invincibleness
esquema	scheme
rezar	pray	entreat	supplicate
presente	present	gift
ferrovia	railway	railroad
janela	window
gratidão	thankfulness	gratefulness	gratitude
recordar	remember	recall	recollect
entrar	enter
substituído	substituted
costumar	be accustomed	used
excedente	remainder	excess
ladeiro	alongside	sideways	slanted
pratear	coat or treat with silver	silver
improvisar	improvise
anterior	earlier	anterior	previous	former	foregoing	prior
automóvel	car	automobile
notícia	information	news item	notice
relembrar	remember	recollect
alto	high	tall
graça	grace	goodwill	favor
suspensos	hanging	interrupted	suspended
agudo	sharp	acute
preocupação	concern	preoccupation	worry
pessoa	person
parcial	partisan	partial
empurra	push
nacional	national
acréscimo	increase	addition
privilegiado	privileged
eqüidade	equity
alíquota	aliquot
tipo	type	kind
tarefa	task
referência	reference
arrogante	arrogant
chocou	shock	stun	hatch	clash	bump
apreender	arrest	apprehend
livre	free
votação	election	voting	polling
abatimento	lessening	low spirits
livro	book
elemento	element
descumprir	not comply with	disobey
pesquisa	survey	research
alagar	flood	overflow
iludir	deceive	illude	mislead
mexer	stir	rummage	tease
infecção	infection
estrutura	structure	frame	framework
rendas	lace	income	revenue
apresentador	presenter
seco	dry	shoal	lifeless	uninteresting
internacional	international
orçamentário	budgetary
copa	cup	dining room	crown	competition	top
poder	might	may	can
professor	professor	teacher
modelo	model
deixar	allow	leave	let
exemplo	model	example	instance
sede	farmhouse	thirst	headquarters
deixaram	allow	leave	let
metade	half
taxa	rate	charge	tax	tuition
dimensão	dimension
acontecer	become	happen	occur
durar	last	endure
confessar	reveal	confess
quilômetros	kilometre	kilometer
condenar	condemn
estragar	ruin	damage	spoil
como	how	as	like
ajeitar	arrange
limpo	clean
milhão	million
material	material
foragido	persecuted	fugitive
arquidiocese	archdiocese
original	model	pattern	original
qual	that	which	how	what	as
torre	tower	steeple	fortress
pedofilia	pedophilia
perseguição	persecution
protocolar	register	conforming to a protocol	protocolize
turbina	turbine
morrer	die
Comitê	committee
com	with
nortista	northerner
aplicou	apply	put into practice
debater	debate
superintendente	superintendent
articulação	articulation
corredor	passage	aisle	corridor	racer	runner	gangway
resultar	result	be the result	originate or arise from
previsto	expected	foreseen
lua	moon
aliviado	eased	relieved
pênalti	penalty
rendeu	vanquish	subject	conquer	subdue
planeta	planet
tóxico	poisonous	toxic
render	vanquish	subject	conquer	subdue
adiar	waive	defer	postpone	adjourn
intercâmbio	exchange
alegria	joy	gladness	delight
comissão	committee	commission
atribuir	attribute	assign to
embaixo	under
apresentou	present	introduce
cerimonial	ceremonial
alfinetar	prick with a pin
coletivo	collective
visível	visible
ciclone	cyclone
federal	federal
transparência	transparency
trancar	lock
torno	faucet	lathe	vice
insuficiência	insufficiency	insufficience
regular	regular
nadador	swimming	swimmer
ressaltar	jut out	rebound	emphasize	highlight
voltar	return	come back
sabedoria	wisdom	learning
avisar	warn	inform	let know	advise	admonish
seduzir	seduce
regional	regional
unir	unite	connect	join	adjoin
sucessão	series	succession	chain	sequence
casal	pair	couple
movimentação	moving	movement
trabalhador	worker
despesa	expenditure	disbursement	expense	outlay
dispensa	exemption	dispensation
gozar	mock	cum	enjoy	tease
correspondente	correspondent
viagem	voyage	trip
residência	domicile	abode	home	residence	dwelling	residency
uma	an
solução	answer	conclusion	solution
impedir	impede	hinder	block	prevent	obstruct
garantido	warranted	assured
chutar	kick	guess	despise
impediu	impede	block	hinder	prevent	obstruct
procurar	search	look for
ajuda	help	support	aid	relief
compra	acquisition	buy	purchase
reduzir	diminish	reduce
barrar	plug	daub
catastrófico	catastrophic
pontuar	punctuate
parlamento	parliament
atirador	rifleman	sharpshooter
regozijar	rejoice	make merry
centímetro	centimetre
trem	luggage	train	suite
alagamento	inundation	overflow
preferido	preferred
povo	folk	people
habitação	dwelling	habitation
culpa	fault	blame
ordenar	order	command	ordain
afirmar	affirm	assert	claim
série	series	grade	serial
ligeiro	quick	fast	swift
fácil	easy	common	simple	natural
mudança	relocation	change	shift
propriedade	property
achar	think	guess	meet	find	come across
declaração	declaration
cento	hundred	the number one hundred
guerra	war
operado	surgery patient	operated
houve	there were	there was
alimentício	alimentary	alimentative
cem	hundred
bombardear	bombard
rodado	track	wheels of cart or carriage
atrás	behind	ago
pontual	punctual
Energia	strength	power	energy
melhora	melioration	improvement
território	territory	land
trajeto	distance	route	length	stretch
especializar	specialize
levantar	raise	get up	lift	stand up
compor	arrange	put together	compose
bala	toffee	taffy	bullet
interditar	interdict
lei	law
retificador	corrected	rectifier	rectified	corrector
razão	cause	ratio	reason	motive
intensidade	intensity
recomendação	recommendation
rechaçar	repulse	throw back	resist	oppose
planetário	planetarium
depreciação	depreciation
percurso	course	passage	trajectory	route
distância	distance
reunir	assemble	congregate	gather	meet
acrescentou	add
aeroportuárias	referring to the airport
bandido	bandit
triunfo	triumph
também	either	likewise	also	too
entrega	surrender	delivery
alcance	reach
província	province
refrigerante	refresher	pop	soda	soft drink
defesa	defense
status	rank	status	condition
prorrogação	deferment	prorogation
comprovar	vouch	prove	confirm
formar	form
perigo	danger	hazard	peril
formal	formal
profissão	profession
coerência	coherence
prestador	obliging	serviceable
existir	exist	occur
indicar	direct	designate	indicate	nominate
aguarda	expect	await	hold	wait
sério	indeed	really	serious
desafetos	disaffection
produção	production
concluir	conclude
herdeiro	heiress	heir	inheritor
separatista	separatist
descontar	discount
mercadoria	swag	merchandise	goods	commodities
trocar	change	substitute	exchange
redução	reduction
decisão	decision
expectativa	expectation	anticipation	hope
sabido	smart cunning fellow	known
pressionaram	compress	press
matar	kill	slaughter	butcher	assassinate
mecanismo	mechanism
reconhecimento	reward	recognition	gratitude
assaltante	assailant	robber
dispor	arrange	put	order	place
orientação	guidance	orientation
esclarecer	clarify	enlighten
estimar	appreciate	value	esteem	appraise
quebra	abatement	rebate	breakage
dado	dice	free	given	addicted to	inclined to
ônibus	bus
leito	berth	bed	cot
pódio	podium
queimado	scorched	burnt	carbonized
principal	principal	chief	main
negociação	negotiation
soberania	dominance	reign	sovereignty
reafirmar	reaffirm
nadar	swim
tremor	quake	shiver	tremor
antecedência	antecedence
requisito	requirement	requisite
vencer	win
consistir	consist	rest in
capturar	capture
rejeição	rejection	refusal	denial
acompanhar	conduct	follow up	escort	accompany	chaperon
hospital	hospital
apresentação	presentation	performance	introduction
biografia	biography
unanimidade	unanimousness	unanimity
conferencia	lecture	convention	conference	talk
desentendimento	misunderstanding
oposição	opposition
intervir	intervene
setor	sector	branch
sudeste	south east
debate	debate
lixo	waste	dump	trash	litter	garbage
mar	sea
mas	but
mal	illness	evil
abrigo	covert	shelter	haven
mau	bad
chocado	amazed	shocked	surprised
desabafo	ease	alleviation	relief
cassado	which was abrogated or repealed
quando	when
dramático	dramatic
existência	existence
beneficente	charitable	beneficent
lazer	leisure
volume	volume
usinas	plant	mill	workshop	factory	works
vestido	dress	dressed
militante	militant
fiscal	fiscal	surveyor	controller
fenômeno	phenomenon
Ainda	still	yet
hepatite	hepatitis
radioativos	radioactive
futuro	future
concordar	consent	agree
justo	exactly	precisely
explodiu	explode
namoro	relationship	love making	love affair
stress	stress
recuar	recede	retreat
disciplinar	disciplinary	discipline
permissão	permission
indicador	indicator	gauge	harbinger
cacique	cheiftain	bigwig
bebido	drink
financiamento	financing
montante	amount	rising	post	sum
ocupar	possess	occupy
internet	internet
explodir	explode
convencido	cocky	conceited	convinced
trâmite	course	path	way
desestabilizar	destabilize
artilharia	artillery
inferior	inferior
gelo	ice
reparar	fix	mend	repair	notice
madeira	wood
comover	touch	move
válido	legal	valid
mel	honey
vento	wind
igreja	church
compensação	compensation
mecânico	mechanic
somar	total	calculate	add
Sete	seven
baile	ball	dance
abaixo	under	below	down	beneath
luz	light
reator	reactor
abuso	abuse
chave	key
Calçada	pavement	sidewalk
hostilidade	hostility
colaborador	collaborator
célula	cell
pedir	beg	ask
terremotos	earthquake
destinar	put aside
vitorioso	victorious	triumphant
tráfego	traffic
nervosismo	jitters	case of nerves
seguido	immediate	continuous	followed
âmbito	scope	range	ambit
checar	examine	check	verify
chuvoso	rainy
único	unique	only	sole
empate	tie
movimentada	busy	active	restless
mensais	monthly
petróleo	petroleum	oil
suficiente	sufficient	enough
nascer	rising	be born	uprising
realidade	actuality	fact	reality
numa	in one	in a
conselheiro	counselor	adviser	councilman
aliado	ally
prefixar	prefix
plástico	plastic
atenderá	serve	attend	answer
chato	dull	flat	boring	even	plain
nulo	invalid	void	null
manifestar	reveal	manifest
pavimentadas	paved
encerrar	enclose	finish	conclude	encompass	close
universidade	university
transporte	transport	transportation
salário	wage	paycheck	salary
escalada	scaling
Dois	two
resistência	opposition	resistance
ideal	ideal
presidência	presidency
inesquecível	unforgettable
amor	love
providenciar	provide
estudar	study
cogitar	cogitate	meditate	ponder
expressivo	meaningful	expressive
deslanchar	set off
beijo	kiss
restar	be left over	remain	survive	rest
olho	eye
armado	equipped	armed
homem	man
contração	contraction
degradação	degradation
relacionar	relate	compare	tell	enter into a relationship
submeter	conquer	dominate	subordinate
fechado	closed
contemporizar	temporizer	temporizing
detalhe	detail
hectare	hectare
humildade	humility	humbleness
acostumado	accustomed	used to
concordância	concordance	agreement
edifício	building
canceladas	canceled
emendar	correct
exercer	carry out	exercise	put into practice
repetir	duplicate	repeat	hash over
exceção	exception
repetiu	duplicate	repeat	hash over
estatísticas	statistics
cutucar	nudge	poke
santo	holy person	saintly	holy	saint
operação	operation
frase	phrase	sentence
placar	appease	placate
enviar	send
autonomia	autonomy
mineral	mineral
sexual	sexual
equipamento	equipment
termômetro	thermometer
propósito	intention	purpose
recompensa	recompense	reward	prize
físico	physical	physicist	physique
pagar	pay
carregar	burden	load	carry
xingar	swear	curse
temer	dread	apprehend	fear
testemunha	testimony	evidence	witness
construtor	constructor
inscrito	inscribed
hotel	hotel
guia	guidance	guide
dor	ache	pain
sigilo	seal	secret	secrecy
consolidar	consolidate
passagem	ticket	passage	excerpt	opening
cobrança	charge	collection
desapontado	frustrated	disappointed
cela	cell
engenhar	invent	contrive	engineer
montar	ride	assemble	mount
revista	muster	journal	magazine
risco	risk	scratch	danger	hazard
montanha	mountain	large amount
revólver	revolver
ilusão	illusion	delusion
vaiar	boo	hiss	hoot
auxiliar	assistant	helper	auxiliary
regulamentar	arrange	regulatory	order	referring to regulations	settle	rules	regulate
atuação	performance	acting
anteontem	day before yesterday
perdão	pardon	forgiveness
ocorrência	happening	occurrence
provocar	provoke
manifestação	manifestation
posição	position
aéreo	aerial	air
data	time	period	date
tarde	afternoon
libertação	liberation	release
mediano	median	average
semana	week
fraudulentas	fraudulent
territorial	territorial	relating to territory
país	nation	country
exportação	exportation
reverso	reverse	backside	verso
revisto	examine	revise	review
relacionado	related
alvo	aim	target
relatar	narrate	describe	report	tell
insurgência	insurrection	insurgence	insurgency
ataque	charge	offensive	attack
industrializados	industrialized
devagar	slowly
atitude	attitude
origem	origin
adiamento	adjournment	postponement	delay
Seleção	team of chosen players	act of selecting	selection
demissão	resignation	dismissal
semestre	semester
investigação	investigation
pelo	for the	by
óleo	oil
desvantagem	disadvantage
apreensão	arrest	apprehension
desistir	desist	give up	quit
pela	for the	by
superioridade	superiority
pele	skin
garupa	croup	hindquarters	haunch
vestir	put on	dress	garb	clothe
transportar	convey	transfer	transport
adiantado	advanced
após	after	behind	past
agüentar	bear	stand	endure	put up with
esforço	effort
chefiados	led by
minoria	minority
desestabilizou	destabilize
correr	run
alternativo	optional	alternative
comunicado	communication	official report
assassinar	assassinate	kill
veículo	vehicle
membro	member
substituto	substitute
centro	center	centre	centrum	core
benefício	benefit
assumir	take over	shoulder	assume
aumentar	raise	rise	increase
epicentro	epicenter
tom	tone	hue	pitch
instalação	installation	fixture
promessa	promise
pena	pity	feather
cena	scene
situação	circumstance	situation
viaduto	overpass	viaduct
chocados	amazed	shocked	surprised
elevar	elevate
temor	apprehension	dread	fear
seriar	seriate	arrange in series
dezena	set of ten	ten
saúde	cheers	health
assustado	frightened
venda	grocery shop	selling	sale
degelo	thaw	thawing
incompleto	incomplete
vário	variegated	various	multicoloured
ganhar	win	earn
amar	love
tempo	time	weather
dano	damage
bandeira	flag	banner
consenso	consentment	consensus	agreement
Lula	cuttlefish	squid
urgência	urgency
emissor	issuing
atenção	attention
ocorrer	happen	occur
piano	piano
concreto	concrete
morto	deceased	defunct	dead
extensão	extension
presidir	preside
dia	day
morte	death
radiação	radiation	irradiation
mundo	world
diplomático	diplomatic
etapa	stage
dobrar	bend	double	fold
redondeza	perfection	harmony	rotundness	roundness
cancelar	cancel
reserva	booking	reservation	reserve
assustador	scary	creepy	frightening
análise	analysis
complicar	complicate	become complicated	entangle
constatar	certify	testify	verify
dez	ten
fenda	rip	opening	slit
imprescindível	vital	indispensable	necessary	must
tirar	remove	take
verão	summer
reassumir	retake	reassume	recover
erradicar	eradicate
terapia	therapy
instalar	install
rejeitar	reject	deny
impressionante	impressive	breathtaking
ouvir	hear	listen
equivalente	equivalent
bônus	bonus
fundar	establish	set up	lay the foundation
busca	search	pursuit	quest
supostamente	supposedly
revogação	repeal	cancellation	annulment	revocation
secundário	secondary education	secondary
aeroportuário	referring to the airport
aeronave	airship	aircraft
driblar	dribble
presídio	presidio	fortress
igualdade	equality	equalness
telefônico	telephonic
autoridade	authority
fraco	weak
contribuição	contribution
número	number
acabar	finish	end
localizar	localize	locate	spot
batalha	battle
recinto	precinct	enclosure	sanctuary
construção	building	construction
estréia	opening	premiere	first of anything
região	region	district	zone
dividir	share	divide
peso	weight
obedecer	obey
estabilidade	stability
pintado	painted
ter	have
morador	dweller	inhabitant	resident
balístico	ballistic
desempenho	performance
predisposição	predisposition
miniatura	miniature
milímetro	millimeter
conseguir	obtain	achieve	get
caber	fit	suitable	be proper
ordem	order	command
temporário	provisional	temporary
remeter	send	remit	consign
tragédia	tragedy
telefonar	phone	telephone
exibir	show	display	exhibit
decisivo	decisive
bronze	bronze
desmoronar	knock down
lado	side
entrou	enter
renunciar	resign	renounce
